UniqueID,State_ID,State,Dist_ID,District,PCA_T_Pop,PCA_Tot_M,PCA_Tot_F,PCA_Tot_SC,PCA_Tot_ST,PCA_Tot_Ur,PCA_Tot_Ru,C08_Tot_Ch,C08_Tot_M,C08_Tot_F,C08_Tot_SC,C08_Tot_ST,C08_Tot_Ur,C08_Tot_Ru,2016_Pop_s,2020_Pop_s
"207","26",Dadra & Nagar Haveli,"496",Dadra & Nagar Haveli,"343709","193760","149949","6186","178564","160595","183114","56918","29915","27003","915","37356","21429","35489",347695.000000000058208,471160.999999999941792
"2","31",Lakshadweep,"587",Lakshadweep,"64473","33123","31350","0","61120","50332","14141","9202","4465","4737","0","8966","7009","2193",32201.000000000000000,26306.000000000000000
"3","34",Puducherry,"637",Karaikal,"200222","97809","102413","35348","0","98102","102120","27289","13677","13612","5447","0","13136","14153",263221.000000000000000,225388.000000000000000
"4","34",Puducherry,"636",Mahe,"41816","19143","22673","144","0","41816","0","5461","2836","2625","15","0","5461","0",7465.000000000000000,12241.000000000000000
"5","28",Andhra Pradesh,"545",East Godavari,"5154296","2569688","2584608","945269","213195","1313972","3840324","725535","367153","358382","145258","35324","179020","546515",5479518.000000000000000,5505101.000000000000000
"6","28",Andhra Pradesh,"543",Vizianagaram,"2344474","1161477","1182997","247728","235556","490911","1853563","343603","176343","167260","38462","44972","67276","276327",2593824.000000000000000,2566108.000000000000000
"7","28",Andhra Pradesh,"546",West Godavari,"3936966","1964918","1972048","811698","109072","808777","3128189","546056","276678","269378","126822","18721","111011","435045",4036263.000000000000000,4051692.000000000000000
"8","28",Andhra Pradesh,"542",Srikakulam,"2703114","1341738","1361376","255664","166118","436703","2266411","403292","208368","194924","41169","31428","62553","340739",2662420.000000000000000,2690387.000000000000000
"9","28",Andhra Pradesh,"551",Y.S.R,"2882469","1451777","1430692","465794","75886","979132","1903337","431613","222823","208790","77239","13185","146019","285594",2983690.000000000000000,2953370.000000000000000
"10","28",Andhra Pradesh,"544",Visakhapatnam,"4290589","2138910","2151679","329486","618500","2035922","2254667","621120","317918","303202","49117","111011","270712","350408",4533878.000000000000000,4571843.000000000000000
"11","28",Andhra Pradesh,"547",Krishna,"4517398","2267375","2250023","871063","132464","1843660","2673738","605015","310650","294365","132779","22876","240198","364817",4750654.000000000000000,4775317.000000000931323
"12","33",Tamil Nadu,"614",Tiruchirappalli,"2722290","1352284","1370006","466561","18198","1338033","1384257","361175","185712","175463","67678","2962","167420","193755",2538720.000000000000000,2915853.000000000000000
"13","33",Tamil Nadu,"619",Thiruvarur,"1264277","626693","637584","430927","3034","257795","1006482","168788","85539","83249","66611","534","33735","135053",1242624.000000000000000,1337930.000000000000000
"14","28",Andhra Pradesh,"548",Guntur,"4887813","2440521","2447292","957407","247089","1652738","3235075","689695","356113","333582","148916","43169","232646","457049",5068354.000000000000000,5008946.000000000000000
"15","28",Andhra Pradesh,"552",Kurnool,"4053463","2039227","2014236","737945","82831","1149286","2904177","691033","355210","335823","133239","16827","189426","501607",4188071.999999999534339,4176164.000000000000000
"16","28",Andhra Pradesh,"549",Prakasam,"3397448","1714764","1682684","787861","151145","664582","2732866","515385","265881","249504","135078","28230","97184","418201",3497851.000000000000000,3512541.000000000000000
"17","36",Telangana,"532",Adilabad,"2741239","1369597","1371642","78007","495794","760259","1980980","447095","228349","218746","78007","99273","114079","333016",2879381.000000000000000,2876839.000000000000000
"18","28",Andhra Pradesh,"550",Sri Potti Sriramulu,"2963557","1492974","1470583","666588","285997","857630","2105927","420128","217931","202197","104522","47988","114448","305680",3141797.000000000000000,3132609.000000000000000
"19","36",Telangana,"534",Karimnagar,"3776269","1880800","1895469","107645","106745","951225","2825044","548904","280957","267947","107645","20922","135014","413890",3946906.000000000000000,3975874.000000000000000
"20","36",Telangana,"535",Medak,"3033288","1523030","1510258","90646","168985","727871","2305417","493154","252038","241116","90646","36140","111791","381363",3108227.000000000000000,3112217.000000000000000
"21","28",Andhra Pradesh,"553",Anantapur,"4081148","2064495","2016653","583135","154127","1145711","2935437","605344","311892","293452","95737","25867","169815","435529",4261229.000000000000000,4327347.000000000000000
"22","36",Telangana,"538",Mahbubnagar,"4053028","2050386","2002642","127639","364269","607692","3445336","702745","361534","341211","127639","78022","102199","600546",4256917.000000000000000,4313143.000000000000000
"23","28",Andhra Pradesh,"554",Chittoor,"4174064","2090204","2083860","785760","159165","1231386","2942678","585162","301174","283988","118218","26872","169952","415210",4439386.000000000000000,4421066.000000000000000
"24","36",Telangana,"539",Nalgonda,"3488809","1759772","1729037","104971","394279","662507","2826302","541259","278455","262804","104971","75059","105799","435460",3726526.000000000000000,3726622.000000000000000
"25","36",Telangana,"540",Warangal,"3512576","1759281","1753295","103805","530656","992333","2520243","552632","284584","268048","103805","101381","145506","407126",3651402.000000000000000,3682605.000000000000000
"26","36",Telangana,"541",Khammam,"2797370","1390988","1406382","72605","765565","655911","2141459","423630","214731","208899","72605","136583","92791","330839",2960810.000000000000000,3030951.999999999534339
"27","33",Tamil Nadu,"626",Ramanathapuram,"1353445","682658","670787","249008","1105","410699","942746","191642","98428","93214","37857","216","58656","132986",1387884.000000000232831,1486428.000000000232831
"28","33",Tamil Nadu,"625",Virudhunagar,"1942288","967709","974579","399831","2294","980226","962062","268054","136752","131302","61397","346","132162","135892",1906523.000000000000000,2046355.000000000000000
"29","33",Tamil Nadu,"624",Theni,"1245899","625683","620216","258200","1835","670481","575418","170789","89866","80923","39800","383","91158","79631",1394530.000000000000000,1360903.000000000000000
"30","33",Tamil Nadu,"621",Pudukkottai,"1618345","803188","815157","284804","1283","316354","1301991","233993","119968","114025","43367","229","43748","190245",1688930.000000000000000,1740755.999999999767169
"31","33",Tamil Nadu,"604",Kancheepuram,"3998252","2012958","1985294","948081","41210","2538336","1459916","494578","252895","241683","132957","7309","300492","194086",4399374.000000000000000,3451561.000000000000000
"32","33",Tamil Nadu,"609",Namakkal,"1726601","869280","857321","345392","57059","696125","1030476","213716","113544","100172","47877","8874","85843","127873",1986314.000000000000000,1482851.999999999767169
"33","33",Tamil Nadu,"602",Thiruvallur,"3728104","1876062","1852042","821646","47243","2428395","1299709","477355","244646","232709","114687","7786","298437","178918",3969648.000000000000000,4063756.000000000000000
"34","33",Tamil Nadu,"633",Tiruppur,"2479052","1246159","1232893","395876","5458","1521111","957941","294068","150616","143452","54898","891","183615","110453",2882580.000000000000000,2709405.000000000000000
"35","33",Tamil Nadu,"632",Coimbatore,"3458045","1729297","1728748","535911","28342","2618940","839105","400479","204666","195813","72029","4194","302631","97848",3345538.000000000000000,3796952.000000000465661
"36","33",Tamil Nadu,"611",The Nilgiris,"735394","360143","375251","235878","32813","435655","299739","98879","49770","49109","33439","5411","59776","39103",745012.000000000000000,758707.000000000000000
"37","33",Tamil Nadu,"610",Erode,"2251744","1129868","1121876","369483","21880","1157976","1093768","264551","136825","127726","49298","3439","135917","128634",3054552.000000000465661,2903934.000000000000000
"38","33",Tamil Nadu,"608",Salem,"3482056","1781571","1700485","580512","119369","1774122","1707934","475634","253664","221970","87816","18056","235630","240004",2909852.000000000000000,3684935.999999999534339
"39","8",Rajasthan,"117",Sirohi,"1036346","534231","502115","201863","292470","208654","827692","203508","108890","94618","40638","64655","35418","168090",1073936.000000000000000,1144469.000000000000000
"40","33",Tamil Nadu,"607",Viluppuram,"3458873","1740819","1718054","1015716","74859","519088","2939785","503106","257376","245730","162150","13318","71994","431112",3073244.000000000000000,3636647.999999999534339
"41","33",Tamil Nadu,"630",Dharmapuri,"1506843","774303","732540","245392","63044","260912","1245931","225048","120573","104475","39035","10699","36949","188099",1382386.000000000000000,1624319.000000000000000
"42","33",Tamil Nadu,"605",Vellore,"3936331","1961688","1974643","860212","72955","1701987","2234344","546851","280039","266812","124381","12871","230594","316257",3997837.000000000000000,4098481.000000000000000
"43","33",Tamil Nadu,"631",Krishnagiri,"1879809","960232","919577","267386","22388","428363","1451446","282994","147754","135240","43227","4242","62371","220623",2196216.000000000000000,1993808.000000000000000
"44","33",Tamil Nadu,"606",Tiruvannamalai,"2464875","1235889","1228986","565329","90954","494945","1969930","337918","173273","164645","83872","15933","65610","272308",2534965.000000000000000,2654256.000000000000000
"45","33",Tamil Nadu,"603",Chennai,"4646732","2335844","2310888","779667","10061","4646732","0","539370","275931","263439","102870","1252","539370","0",4494740.000000000000000,5806835.000000000000000
"46","1",Jammu & Kashmir,"8",Baramula,"1008039","534733","473306","1476","37705","182500","825539","183705","95107","88598","14","7597","25560","158145",1601451.000000000000000,1415578.000000000000000
"47","1",Jammu & Kashmir,"7",Kathua,"616435","326109","290326","141224","53307","89713","526722","103877","56780","47097","24898","11514","12686","91191",776331.000000000000000,722197.000000000000000
"48","37",Ladakh,"3",Leh(Ladakh),"133487","78971","54516","488","95857","45671","87816","15313","7883","7430","17","13501","4250","11063",283559.000000000000000,154691.000000000000000
"49","1",Jammu & Kashmir,"2",Badgam,"753745","398041","355704","368","23912","97912","655833","153657","80896","72761","4","6418","15293","138364",1653020.000000000232831,1755727.000000000000000
"50","1",Jammu & Kashmir,"1",Kupwara,"870354","474190","396164","1048","70352","104729","765625","191374","100498","90876","4","17066","23458","167916",675598.000000000116415,992792.000000000000000
"51","1",Jammu & Kashmir,"10",Srinagar,"1236829","651124","585705","1068","8935","1219516","17313","175080","91410","83670","17","1741","172202","2878",211108.000000000000000,265328.000000000000000
"52","1",Jammu & Kashmir,"11",Ganderbal,"297446","158720","138726","117","61070","47039","250407","58418","30699","27719","6","14876","8672","49746",187501.000000000000000,458491.000000000058208
"53","1",Jammu & Kashmir,"18",Kishtwar,"230696","120165","110531","14307","38149","14865","215831","45348","23409","21939","2851","8691","2176","43172",299382.000000000000000,283152.000000000000000
"54","1",Jammu & Kashmir,"9",Bandipore,"392232","207680","184552","392","75374","65361","326871","76266","39830","36436","10","16885","11459","64807",196931.000000000000000,399868.999999999941792
"55","1",Jammu & Kashmir,"6",Rajouri,"642415","345351","297064","48157","232815","52314","590101","119576","62956","56620","8546","50432","5983","113593",664921.000000000000000,820790.000000000116415
"56","8",Rajasthan,"103",Jhunjhunun,"2137045","1095896","1041149","360709","41629","489079","1647966","386692","208060","178632","70106","7711","89133","297559",2261230.000000000000000,2421338.000000000000000
"57","1",Jammu & Kashmir,"5",Punch,"476835","251899","224936","556","176101","38630","438205","93587","48881","44706","34","38032","6142","87445",350947.000000000058208,501320.000000000000000
"58","37",Ladakh,"4",Kargil,"140802","77785","63017","18","122336","16338","124464","22931","11889","11042","3","21831","1975","20956",171225.000000000000000,165940.000000000000000
"59","1",Jammu & Kashmir,"12",Phulwama,"560440","293064","267376","402","22607","80462","479978","85809","44449","41360","3","4887","10610","75199",390844.999999999941792,592166.000000000116415
"60","1",Jammu & Kashmir,"13",Shupiyan,"266215","136480","129735","43","21820","16360","249855","48821","24780","24041","0","5321","1891","46930",330958.000000000000000,434683.000000000058208
"61","1",Jammu & Kashmir,"14",Anantnag,"1078692","559767","518925","1826","116006","282887","795805","214064","111773","102291","2","27757","50644","163420",455167.000000000058208,646664.000000000000000
"62","1",Jammu & Kashmir,"15",Kulgam,"424483","217620","206863","21","26525","80613","343870","75721","38794","36927","4","5940","12872","62849",506363.000000000058208,714153.999999999883585
"63","1",Jammu & Kashmir,"16",Doda,"409936","213641","196295","53408","39216","32689","377247","79100","40918","38182","10427","8679","5426","73674",279074.000000000000000,390594.000000000000000
"64","1",Jammu & Kashmir,"17",Ramban,"283713","149132","134581","13920","39772","11811","271902","57724","29793","27931","3052","8561","1602","56122",184796.000000000000000,308500.999999999941792
"65","1",Jammu & Kashmir,"20",Reasi,"314667","166461","148206","37757","88365","26996","287671","62365","32449","29916","6959","19516","3836","58529",377172.999999999941792,411331.000000000058208
"66","1",Jammu & Kashmir,"19",Udhampur,"554985","296784","258201","138569","56309","108208","446777","97198","51463","45735","27152","11646","13695","83503",670820.000000000000000,732389.000000000000000
"67","8",Rajasthan,"123",Rajsamand,"1156597","581339","575258","148168","160809","183820","972777","213275","111106","102169","28148","32775","31106","182169",1370611.999999999767169,1243487.000000000000000
"68","1",Jammu & Kashmir,"21",Jammu,"1529958","813821","716137","377991","69193","765013","764945","213812","119145","94667","58766","13927","95514","118298",1887627.000000000000000,1401964.000000000232831
"69","1",Jammu & Kashmir,"22",Samba,"318898","169124","149774","91835","17573","53615","265283","48059","27017","21042","14593","3321","7286","40773",1018884.000000000000000,731129.000000000000000
"70","23",MadyaPradesh,"432",Neemuch,"826067","422653","403414","111162","71441","245230","580837","140011","72405","67606","19802","13919","38951","101060",889095.000000000000000,920022.000000000116415
"71","23",MadyaPradesh,"435",Ujjain,"1986864","1016289","970575","523869","48730","779213","1207651","344335","178372","165963","98328","9758","119269","225066",2152598.000000000000000,2309266.000000000000000
"72","23",MadyaPradesh,"434",Ratlam,"1455069","738241","716828","198612","409865","435031","1020038","267311","136967","130344","36508","90535","67634","199677",1519080.000000000000000,1604579.000000000000000
"73","23",MadyaPradesh,"422",Datia,"786754","420157","366597","200270","15061","181982","604772","144214","77051","67163","38596","3398","31551","112663",994179.000000000000000,1056636.000000000000000
"74","23",MadyaPradesh,"433",Mandsaur,"1340411","682851","657560","249024","33092","277604","1062807","234804","121139","113665","46977","6873","43281","191523",1368762.000000000000000,1441742.000000000000000
"75","23",MadyaPradesh,"436",Shajapur,"1512681","780520","732161","353914","37836","293548","1219133","284625","146901","137724","71278","7960","52013","232612",1489350.000000000000000,1595353.000000000000000
"76","23",MadyaPradesh,"441",Barwani,"1385881","699340","686541","87991","962145","204069","1181812","302524","152053","150471","18184","226334","36131","266393",1075080.000000000000000,1372859.000000000000000
"77","23",MadyaPradesh,"458",Guna,"1241519","649362","592157","193115","190819","312675","928844","253171","131808","121363","41567","43555","57501","195670",1355843.999999999767169,1445221.000000000000000
"78","23",MadyaPradesh,"418",Sheopur,"687861","361784","326077","108391","161448","107352","580509","141737","74678","67059","21999","37744","20466","121271",1020710.000000000116415,712268.000000000000000
"79","23",MadyaPradesh,"465",Alirajpur,"728999","362542","366457","26877","648638","57074","671925","170194","86044","84150","6255","155056","10392","159802",809471.000000000000000,787075.000000000000000
"80","23",MadyaPradesh,"464",Jhabua,"1025048","515023","510025","17427","891818","91983","933065","231628","119486","112142","3382","210204","16332","215296",1020220.000000000000000,1147143.000000000000000
"81","8",Rajasthan,"128",Baran,"1222755","633945","588810","221184","276857","254214","968541","229594","120421","109173","42272","55529","45407","184187",1102483.000000000000000,1402553.000000000000000
"82","8",Rajasthan,"118",Pali,"2037573","1025422","1012151","398096","144578","460006","1577567","392144","205301","186843","81578","30740","81098","311046",2133788.000000000000000,2276920.000000000000000
"83","8",Rajasthan,"108",Sawai Madhopur,"1335551","704031","631520","278789","285848","266467","1069084","260258","138413","121845","56139","55387","47574","212684",1419838.000000000000000,1540281.000000000000000
"84","8",Rajasthan,"107",Karauli,"1458248","783639","674609","354465","324960","218105","1240143","297978","162112","135866","76448","65309","42548","255430",1267198.000000000000000,1567490.000000000000000
"85","23",MadyaPradesh,"442",Rajgarh,"1545814","790212","755602","295718","53751","276457","1269357","295880","151446","144434","61656","11342","50189","245691",1598384.000000000000000,1705701.000000000000000
"86","23",MadyaPradesh,"425",Chhatarpur,"1762375","936121","826254","405313","73597","399016","1363359","359244","188436","170808","91526","17344","71868","287376",1893369.000000000000000,2021305.000000000000000
"87","8",Rajasthan,"110",Jaipur,"6626178","3468507","3157671","1003302","527966","3471847","3154331","1193583","634390","559193","196749","108408","564310","629273",7691835.000000000000000,7539446.000000000000000
"88","23",MadyaPradesh,"423",Shivpuri,"1726050","919795","806255","321515","227802","295423","1430627","349369","184322","165047","67384","52124","52097","297272",1812673.000000000000000,1888869.000000000000000
"89","8",Rajasthan,"105",Bharatpur,"2548462","1355726","1192736","557305","54090","495099","2053363","513021","276200","236821","117196","10165","88883","424138",2666958.000000000000000,2854827.000000000000000
"90","23",MadyaPradesh,"440",Khargone (West Nimar),"1873046","953121","919925","209091","730169","298856","1574190","369531","186537","182994","40062","171747","50547","318984",2213475.000000000000000,2111494.000000000000000
"91","23",MadyaPradesh,"447",Betul,"1575362","799236","776126","159296","667018","309151","1266211","275013","138641","136372","25178","138465","44323","230690",1559563.000000000000000,1669499.000000000000000
"92","8",Rajasthan,"102",Churu,"2039547","1051446","988101","451721","11245","576235","1463312","402357","211325","191032","96817","2193","108191","294166",1693099.000000000000000,2247614.000000000000000
"93","23",MadyaPradesh,"419",Morena,"1965970","1068417","897553","421519","17030","470462","1495508","384316","210613","173703","87382","4067","86098","298218",1734064.000000000000000,2224355.000000000000000
"94","23",MadyaPradesh,"420",Bhind,"1703005","926843","776162","374799","6131","432922","1270083","313119","171304","141815","73405","1246","78224","234895",1843059.999999999767169,1946650.000000000000000
"95","8",Rajasthan,"99",Ganganagar,"1969168","1043340","925828","720412","13477","535432","1433736","335801","181505","154296","140750","2476","83950","251851",2123061.000000000000000,2135189.000000000000000
"96","23",MadyaPradesh,"467",Burhanpur,"757847","388504","369343","64254","230095","260287","497560","141686","72969","68717","11162","53419","42159","99527",612476.000000000000000,826195.000000000000000
"97","23",MadyaPradesh,"466",Khandwa (East Nimar),"1310061","674329","635732","156601","459122","259436","1050625","249827","128613","121214","29343","103158","42604","207223",1546266.000000000000000,1462789.000000000000000
"98","23",MadyaPradesh,"445",Sehore,"1311332","683743","627589","271281","145512","248462","1062870","256000","133023","122977","55242","33723","43055","212945",1398220.000000000232831,1510155.000000000000000
"99","3",Punjab,"41",Ludhiana,"3498739","1867816","1630923","923358","0","2069708","1429031","496084","274277","221807","147147","0","293908","202176",3582259.000000000000000,3713161.000000000000000
"100","23",MadyaPradesh,"457",Balaghat,"1701698","842178","859520","125426","383026","244816","1456882","280634","141483","139151","18901","70777","36171","244463",1763415.000000000000000,1867626.000000000000000
"101","23",MadyaPradesh,"455",Chhindwara,"2090922","1064468","1026454","232244","769778","505183","1585739","354200","180260","173940","36400","150767","73489","280711",2215684.000000000000000,2356856.000000000000000
"102","23",MadyaPradesh,"456",Seoni,"1379131","695879","683252","130797","519856","163890","1215241","241134","120954","120180","21717","99543","24367","216767",1371007.000000000000000,1460835.000000000000000
"103","3",Punjab,"48",Patiala,"1895686","1002522","893164","465359","0","763280","1132406","267623","150401","117222","78038","0","99571","168052",1932012.000000000232831,2085557.000000000000000
"104","3",Punjab,"40",Fatehgarh Sahib,"600163","320795","279368","192493","0","185482","414681","81815","46079","35736","30029","0","25424","56391",546727.000000000000000,646205.000000000000000
"105","23",MadyaPradesh,"454",Mandla,"1054905","525272","529633","48425","610528","130189","924716","179839","90244","89595","7748","109184","18921","160918",1184513.000000000000000,1175434.000000000000000
"106","5",Uttarkhand,"61",Garhwal,"687271","326829","360442","122361","2215","112703","574568","117295","60469","56826","24522","424","18082","99213",773241.000000000000000,835992.000000000000000
"107","23",MadyaPradesh,"462",Sidhi,"1127033","575912","551121","130202","313304","93121","1033912","232576","118544","114032","29960","67879","17837","214739",1138004.000000000000000,1218323.999999999767169
"108","3",Punjab,"52",S.A.S. Nagar,"994628","529253","465375","216231","0","544611","450017","139425","78407","61018","35198","0","72671","66754",922031.000000000000000,1032484.000000000000000
"109","23",MadyaPradesh,"453",Dindori,"704524","351913","352611","39782","455789","32318","672206","122629","61133","61496","6789","81213","5069","117560",635689.999999999883585,782035.000000000000000
"110","23",MadyaPradesh,"461",Anuppur,"749237","379114","370123","74385","358543","205241","543996","131788","66336","65452","14008","64278","34615","97173",898225.999999999883585,1076268.000000000000000
"111","5",Uttarkhand,"64",Almora,"622506","291081","331425","150995","1281","62314","560192","108445","55038","53407","30084","184","8340","100105",685763.000000000000000,683644.000000000000000
"112","23",MadyaPradesh,"460",Shahdol,"1066063","540021","526042","89733","476008","219600","846463","195313","98314","96999","17350","92223","35228","160085",830467.000000000000000,907641.999999999883585
"113","3",Punjab,"36",Kapurthala,"815168","426311","388857","276707","0","282462","532706","117719","65762","51957","45087","0","38437","79282",850817.999999999883585,862039.000000000000000
"114","23",MadyaPradesh,"463",Singrauli,"1178273","613637","564636","150664","383994","226786","951487","250625","127860","122765","33470","85997","42881","207744",1231139.999999999767169,1309941.000000000000000
"115","3",Punjab,"49",Amritsar,"2490656","1318408","1172248","770864","0","1334611","1156045","364644","204240","160404","134080","0","179301","185343",2493727.000000000000000,2633028.000000000000000
"116","23",MadyaPradesh,"430",Rewa,"2365106","1225100","1140006","383508","311985","395785","1969321","460945","239839","221106","86344","68197","69787","391158",2591907.000000000000000,2752750.000000000000000
"117","23",MadyaPradesh,"427",Sagar,"2378458","1256257","1122201","501630","221936","708796","1669662","443943","230130","213813","99223","47119","115666","328277",2593159.000000000000000,2771264.000000000000000
"118","21",Odisha,"399",Malkangiri,"613192","303624","309568","138295","354614","49528","563664","120130","60239","59891","26270","73035","8568","111562",744160.000000000000000,649628.000000000000000
"119","23",MadyaPradesh,"429",Satna,"2228935","1157495","1071440","398569","319975","474418","1754517","430809","223596","207213","85695","67483","83960","346849",2368312.000000000465661,2563491.000000000000000
"120","23",MadyaPradesh,"459",Ashoknagar,"845071","443837","401234","175764","82072","153684","691387","170973","89025","81948","37611","18403","28719","142254",905577.000000000000000,972196.000000000000000
"121","5",Uttarkhand,"67",Udham Singh Nagar,"1648902","858783","790119","238264","123037","586760","1062142","309861","163896","145965","50377","21517","106060","203801",1821061.000000000000000,1846287.000000000000000
"122","21",Odisha,"398",Koraput,"1379647","678809","700838","196540","697583","226169","1153478","254759","126669","128090","37282","139536","34704","220055",1434030.000000000000000,1482317.000000000000000
"123","23",MadyaPradesh,"426",Panna,"1016520","533480","483040","207990","170879","125335","891185","206755","107071","99684","45257","37838","22579","184176",1037088.000000000000000,1114086.000000000000000
"124","5",Uttarkhand,"57",Chamoli,"391605","193991","197614","79317","12260","59396","332209","68164","34995","33169","16111","1572","9487","58677",518292.999999999941792,421688.000000000000000
"125","23",MadyaPradesh,"424",Tikamgarh,"1445166","760355","684811","361604","67857","249873","1195293","285712","148949","136763","75065","15027","45392","240320",1478218.000000000000000,1605955.999999999767169
"126","5",Uttarkhand,"56",Uttarkashi,"330086","168597","161489","80567","3512","24305","305781","63005","32610","30395","16779","505","4208","58797",402920.999999999941792,372636.999999999941792
"127","23",MadyaPradesh,"450",Katni,"1292042","662013","630029","155717","317699","263543","1028499","240729","123060","117669","30716","65285","41381","199348",1195511.000000000000000,1362270.000000000000000
"128","23",MadyaPradesh,"428",Damoh,"1264219","661873","602346","246337","166295","250551","1013668","236888","122375","114513","48158","35221","40645","196243",1461093.000000000000000,1533547.000000000000000
"129","23",MadyaPradesh,"421",Gwalior,"2032036","1090327","941709","393068","72133","1273792","758244","349166","191154","158012","72863","15569","198588","150578",1945982.000000000000000,2053613.000000000000000
"130","23",MadyaPradesh,"451",Jabalpur,"2463289","1277278","1186011","348029","375231","1440034","1023255","378811","196705","182106","57648","68160","200765","178046",2615945.000000000000000,2660682.000000000000000
"131","23",MadyaPradesh,"431",Umaria,"644758","330674","314084","58147","300687","110544","534214","124568","63399","61169","11326","61741","19002","105566",844523.000000000000000,750047.000000000000000
"132","21",Odisha,"396",Rayagada,"967911","471960","495951","139514","541905","146966","820945","185348","93401","91947","27468","113425","21774","163574",835220.000000000000000,1039017.999999999883585
"133","23",MadyaPradesh,"452",Narsimhapur,"1091854","568810","523044","184155","145879","203540","888314","179989","93512","86477","32830","26890","30814","149175",1084958.000000000000000,1141927.000000000000000
"134","23",MadyaPradesh,"443",Vidisha,"1458875","769568","689307","292144","67603","339618","1119257","296206","152912","143294","64438","15115","61017","235189",1442881.000000000000000,1572262.000000000000000
"135","5",Uttarkhand,"58",Rudraprayag,"242285","114589","127696","47679","386","9925","232360","43988","22654","21334","10218","62","1543","42445",174755.000000000000000,280612.000000000000000
"136","23",MadyaPradesh,"444",Bhopal,"2371061","1236130","1134931","357516","69429","1917051","454010","381826","199669","182157","65014","12638","288962","92864",2558484.000000000000000,2709321.000000000000000
"137","23",MadyaPradesh,"446",Raisen,"1331597","700358","631239","225891","205006","303425","1028172","260338","134324","126014","46353","46531","55602","204736",1291330.000000000000000,1418582.000000000000000
"138","23",MadyaPradesh,"449",Hoshangabad,"1241350","648725","592625","205007","197300","389986","851364","212231","110065","102166","36879","40486","57456","154775",1223002.000000000000000,1298245.000000000000000
"139","23",MadyaPradesh,"439",Indore,"3276697","1699627","1577070","545239","217679","2427709","848988","509574","268200","241374","92903","45504","356919","152655",3526172.000000000000000,3701678.000000000000000
"140","23",MadyaPradesh,"448",Harda,"570465","294838","275627","92865","159678","119364","451101","105135","54435","50700","17598","35662","19626","85509",608679.000000000000000,630668.000000000000000
"141","23",MadyaPradesh,"437",Dewas,"1563715","805359","758356","292007","272701","451759","1111956","288889","149417","139472","56019","62319","75585","213304",1691673.000000000000000,1843601.000000000000000
"142","21",Odisha,"389",Gajapati,"577817","282882","294935","39175","313714","70666","507151","110208","55314","54894","6663","67325","11114","99094",615398.000000000116415,572966.000000000000000
"143","23",MadyaPradesh,"438",Dhar,"2185793","1112725","1073068","145436","1222814","413221","1772572","432083","221324","210759","27742","268683","70680","361403",2203792.000000000000000,2415641.000000000000000
"144","21",Odisha,"388",Ganjam,"3529031","1779218","1749813","688235","118928","768001","2761030","597073","301792","295281","127993","24424","108364","488709",3626315.000000000000000,3740031.000000000000000
"145","5",Uttarkhand,"60",Dehradun,"1696694","892199","804495","228901","111663","941941","754753","260937","140481","120456","40098","21592","134245","126692",1725494.000000000000000,1803442.000000000000000
"146","5",Uttarkhand,"59",Tehri Garhwal,"618931","297986","320945","102130","875","70139","548792","115656","59936","55720","22318","138","11934","103722",503756.999999999941792,694117.000000000000000
"147","5",Uttarkhand,"62",Pithoragarh,"483439","239306","244133","120378","19535","69605","413834","82098","43267","38831","23729","2973","12034","70064",531689.000000000000000,554825.000000000000000
"148","5",Uttarkhand,"63",Bageshwar,"259898","124326","135572","72061","1982","9079","250819","45114","22969","22145","14323","279","1425","43689",222263.000000000000000,287120.000000000000000
"149","5",Uttarkhand,"66",Nainital,"954605","493666","460939","191206","7495","371734","582871","158504","83801","74703","35161","1293","58015","100489",720969.000000000000000,965617.000000000000000
"150","5",Uttarkhand,"65",Champawat,"259648","131125","128523","47383","1339","38343","221305","49719","25678","24041","10068","226","6773","42946",373838.000000000000000,394094.000000000000000
"151","5",Uttarkhand,"68",Haridwar,"1890422","1005295","885127","411274","6323","693094","1197328","350408","189448","160960","82443","1240","108531","241877",1894915.999999999767169,2024119.000000000000000
"152","21",Odisha,"397",Nabarangapur,"1220946","604812","616134","177384","681173","87625","1133321","236928","118229","118699","33314","139682","15266","221662",1409035.000000000000000,1329397.000000000000000
"153","22",Chhattisgarh,"403",Raigarh,"1493984","750278","743706","224942","505609","246302","1247682","244546","124095","120451","39132","87842","37025","207521",1325939.000000000000000,1528739.999999999767169
"154","22",Chhattisgarh,"402",Jashpur,"851669","424747","426922","48844","530378","75992","775677","144575","72461","72114","8375","90656","13302","131273",999501.000000000000000,963360.000000000000000
"155","22",Chhattisgarh,"410",Raipur,"4063872","2048186","2015686","724250","476446","1483289","2580583","711942","361982","349960","140420","86253","232765","479177",3627117.000000000000000,4026863.000000000000000
"156","22",Chhattisgarh,"416",Dakshin Bastar Dantewada,"533638","264142","269496","12996","410255","96233","437405","106783","55536","51247","2287","87112","16988","89795",637391.000000000000000,598845.000000000000000
"157","21",Odisha,"395",Kalahandi,"1576869","787101","789768","286580","449456","121987","1454882","276516","139183","137333","53438","84874","19121","257395",1586793.000000000000000,1701171.999999999767169
"158","22",Chhattisgarh,"417",Bijapur,"255230","128663","126567","10122","204189","29600","225630","55872","29604","26268","1912","46968","5931","49941",214688.000000000000000,269689.000000000000000
"159","22",Chhattisgarh,"414",Bastar,"1413199","698487","714712","37963","931780","193494","1219705","259679","130185","129494","6597","180958","29276","230403",1595565.000000000000000,1620206.000000000000000
"160","22",Chhattisgarh,"415",Narayanpur,"139820","70104","69716","4979","108161","22106","117714","30669","15643","15026","1002","25222","4031","26638",112905.000000000000000,144636.000000000000000
"161","22",Chhattisgarh,"411",Mahasamund,"1032754","511967","520787","139581","279896","120152","912602","172114","86736","85378","25995","48311","18992","153122",1104891.000000000000000,1103008.000000000000000
"162","22",Chhattisgarh,"413",Uttar Bastar Kanker,"748941","373338","375603","31543","414770","76761","672180","127669","64513","63156","4961","73428","11723","115946",643270.000000000116415,831157.000000000000000
"163","22",Chhattisgarh,"412",Dhamtari,"799781","397897","401884","58581","207633","149195","650586","132379","65972","66407","10423","33244","23081","109298",815193.999999999883585,849008.000000000000000
"164","22",Chhattisgarh,"405",Janjgir-Champa,"1619707","815717","803990","397908","187196","225061","1394646","292591","148184","144407","77560","34266","36172","256419",1472344.000000000000000,1846751.000000000000000
"165","22",Chhattisgarh,"409",Durg,"3343872","1682101","1661771","458040","397416","1284765","2059107","551436","279879","271557","80639","64794","189175","362261",3855457.000000000000000,4109750.000000000000000
"166","22",Chhattisgarh,"408",Rajnandgaon,"1537133","762855","774278","156623","405194","272512","1264621","269016","134638","134378","27309","73415","40326","228690",2049051.000000000000000,1804391.000000000000000
"167","21",Odisha,"390",Kandhamal,"733110","359945","373165","115544","392820","72279","660831","142353","71041","71312","21168","82259","12342","130011",612523.000000000000000,773412.000000000000000
"168","22",Chhattisgarh,"407",Kabeerdham,"822526","412058","410468","119798","167043","87395","735131","158390","79715","78675","24041","33788","15156","143234",825540.000000000000000,1139129.000000000000000
"169","22",Chhattisgarh,"406",Bilaspur,"2663629","1351574","1312055","552992","498469","679870","1983759","492837","251186","241651","112570","93403","105481","387356",2613108.000000000000000,3167984.000000000000000
"170","22",Chhattisgarh,"404",Korba,"1206640","612915","593725","124679","493559","446290","760350","208183","105474","102709","21989","89835","70099","138084",1599273.000000000000000,1337538.000000000000000
"171","22",Chhattisgarh,"401",Surguja,"2359886","1193129","1166757","115652","1300628","242921","2116965","448617","228139","220478","22426","254753","41254","407363",2536566.000000000000000,2664704.000000000000000
"172","22",Chhattisgarh,"400",Koriya,"658917","334737","324180","54776","304280","205299","453618","114849","58357","56492","9799","55680","32560","82289",671433.999999999883585,769848.000000000000000
"173","21",Odisha,"394",Nuapada,"610382","301962","308420","82159","206327","34054","576328","107187","53520","53667","14440","39735","5179","102008",716334.000000000116415,642755.000000000000000
"174","21",Odisha,"385",Nayagarh,"962789","502636","460153","136399","58691","79738","883051","145372","75591","69781","22385","10685","11164","134208",881206.000000000116415,995601.999999999883585
"175","21",Odisha,"386",Khordha,"2251673","1167137","1084536","297472","115051","1084316","1167357","317454","164796","152658","47372","25199","143135","174319",2914443.000000000000000,2590945.000000000000000
"176","21",Odisha,"387",Puri,"1698730","865380","833350","325133","6129","264930","1433800","246000","126257","119743","52614","1668","35787","210213",1612250.000000000000000,1937247.000000000000000
"177","21",Odisha,"380",Jagatsinghapur,"1136971","577865","559106","248152","7862","115980","1020991","154541","79514","75027","36788","1759","16877","137664",1276518.000000000000000,1237195.000000000000000
"178","21",Odisha,"379",Kendrapara,"1440361","717814","722547","309780","9484","83534","1356827","220983","112404","108579","51957","2448","12195","208788",1270113.000000000000000,1551222.000000000000000
"179","21",Odisha,"381",Cuttack,"2624470","1352760","1271710","498633","93745","736047","1888423","363243","185952","177291","75562","18979","92649","270594",2914535.000000000000000,2529601.000000000000000
"180","21",Odisha,"383",Dhenkanal,"1192811","612593","580218","234079","162056","117506","1075305","179778","91898","87880","38797","31490","15690","164088",1076616.000000000000000,1278042.000000000000000
"181","21",Odisha,"384",Anugul,"1273821","655718","618103","239552","179603","206546","1067275","204117","105020","99097","42335","35845","29737","174380",1498568.000000000000000,1355966.000000000000000
"182","21",Odisha,"372",Sambalpur,"1041099","526877","514222","191827","355261","308093","733006","153825","78236","75589","28979","59659","42192","111633",1309037.000000000000000,1137683.000000000000000
"183","21",Odisha,"374",Sundargarh,"2093437","1061147","1032290","191660","1062349","738097","1355340","342843","172933","169910","30698","192099","106252","236591",2207865.000000000000000,2247919.000000000000000
"184","21",Odisha,"375",Kendujhar,"1801733","906487","895246","209357","818878","253059","1548674","302271","152790","149481","33434","158184","39228","263043",1895507.999999999767169,1940674.000000000000000
"185","21",Odisha,"382",Jajapur,"1827192","926034","901158","433387","151432","135097","1692095","278103","142272","135831","70727","31863","20181","257922",1635486.000000000000000,1937059.000000000000000
"186","21",Odisha,"378",Bhadrak,"1506337","760260","746077","334896","30428","185838","1320499","245751","124708","121043","59686","6335","29851","215900",1314549.000000000000000,1609619.000000000000000
"187","21",Odisha,"377",Baleshwar,"2320529","1185787","1134742","478586","275678","253293","2067236","380118","193514","186604","86104","56063","36988","343130",2535682.000000000000000,2429827.000000000000000
"188","19",West Bengal,"340",Puruliya,"2930115","1496996","1433119","567767","540652","373314","2556801","496503","253285","243218","102013","92791","57608","438895",3081770.000000000000000,3161709.000000000000000
"189","19",West Bengal,"344",Paschim Medinipur,"5913457","3007885","2905572","1128269","880015","722686","5190771","903109","459339","443770","186622","146276","92468","810641",7368967.000000000000000,6329658.000000000000000
"190","19",West Bengal,"338",Hugli,"5519145","2814653","2704492","1344021","229243","2128499","3390646","733734","373367","360367","202955","36809","257369","476365",5513218.000000000000000,5593209.000000000000000
"191","19",West Bengal,"336",Nadia,"5167600","2653768","2513832","1546917","140700","1438873","3728727","751121","382968","368153","227651","23908","172337","578784",5535288.000000000000000,5707808.000000000000000
"192","19",West Bengal,"343",South Twenty Four Parganas,"8161961","4173778","3988183","2464032","96976","2087773","6074188","1324061","674607","649454","374107","17184","289483","1034578",6904728.000000000000000,7483443.000000000000000
"193","19",West Bengal,"335",Barddhaman,"7717563","3966889","3750674","2115719","489447","3078299","4639264","1115008","571227","543781","337453","84160","425286","689722",7913113.000000000000000,7933314.000000000000000
"194","19",West Bengal,"334",Birbhum,"3502404","1790920","1711484","1033140","242484","449448","3052956","576701","295019","281682","175418","45114","63155","513546",3698620.000000000000000,3834732.000000000000000
"195","19",West Bengal,"329",Koch Bihar,"2819086","1451542","1367544","1414336","18125","289434","2529652","459568","234273","225295","227119","3127","35511","424057",2626946.000000000000000,2880385.000000000000000
"196","19",West Bengal,"327",Darjiling,"1846823","937259","909564","317275","397389","727963","1118860","288110","147219","140891","53493","62372","106515","181595",2166836.000000000000000,2205613.000000000000000
"197","19",West Bengal,"345",Purba Medinipur,"5095875","2629834","2466041","745434","27952","592714","4503161","782405","399315","383090","125977","4655","86208","696197",4041554.000000000000000,5335759.999999999068677
"198","19",West Bengal,"337",North Twenty Four Parganas,"10009781","5119389","4890392","2169084","264597","5732162","4277619","1349016","690499","658517","305227","42668","681831","667185",10797420.000000000000000,11092158.000000000000000
"199","19",West Bengal,"333",Murshidabad,"7103807","3627564","3476243","897534","91035","1400692","5703115","1311486","666613","644873","153780","17787","252550","1058936",7270659.000000000000000,7434145.000000000000000
"200","13",Nagaland,"267",Tuensang,"196596","101933","94663","0","190916","36774","159822","43197","22681","20516","0","42436","7672","35525",187258.000000000000000,174097.000000000000000
"201","13",Nagaland,"264",Wokha,"166343","84505","81838","0","156621","35004","131339","31335","15917","15418","0","29702","6119","25216",151796.000000000000000,146466.000000000000000
"202","13",Nagaland,"266",Phek,"163418","83743","79675","0","157146","24575","138843","34157","17781","16376","0","33379","4904","29253",148752.000000000000000,146511.000000000000000
"203","13",Nagaland,"265",Dimapur,"378811","197394","181417","0","223989","197869","180942","67360","34517","32843","0","40859","32115","35245",407696.999999999941792,389166.000000000000000
"204","13",Nagaland,"271",Peren,"95219","49714","45505","0","84242","13790","81429","20103","10616","9487","0","18001","2978","17125",52429.000000000000000,80173.000000000000000
"205","9",Uttar Pradesh,"144",Mahamaya Nagar,"1564708","836127","728581","387554","268","332693","1232015","318261","171951","146310","83253","41","62281","255980",1834217.000000000000000,1715096.000000000000000
"206","9",Uttar Pradesh,"158",Rae Bareli,"3405559","1752542","1653017","1030367","1756","307995","3097564","685348","356295","329053","220160","344","51441","633907",3477951.000000000000000,3755126.000000000000000
"207","1",Jammu & Kashmir,"0",NA,,,,,,,,,,,,,,,,
"208","20",Jharkhand,"368",Pashchimi Singhbhum,"1502338","749385","752953","56986","1011296","218034","1284304","301267","153254","148013","10589","213802","35879","265388",1573885.000000000000000,1673010.000000000000000
"209","20",Jharkhand,"356",Lohardaga,"461790","232629","229161","15330","262734","57411","404379","102470","52134","50336","3465","60797","10640","91830",492024.999999999941792,587037.000000000000000
"210","20",Jharkhand,"353",Pakur,"900422","452661","447761","28469","379054","67512","832910","187287","96075","91212","5825","74790","13285","174002",872398.000000000116415,1006171.000000000000000
"211","29",Karnataka,"581",Kolar,"1536401","776396","760005","465867","78875","480073","1056328","228594","116728","111866","71163","12672","72537","156057",1664726.000000000000000,1715224.000000000000000
"212","29",Karnataka,"555",Belgaum,"4779661","2423063","2356598","577418","297198","1211195","3568466","740112","385719","354393","96125","49986","173942","566170",4973553.000000000000000,5139714.000000000000000
"213","32",Kerala,"599",Pathanamthitta,"1197412","561716","635696","164465","8108","131613","1065799","135833","69178","66655","19774","1092","15127","120706",1205504.000000000000000,1156966.000000000000000
"214","32",Kerala,"598",Alappuzha,"2127789","1013142","1114647","201211","6574","1148146","979643","254233","129546","124687","23710","832","137758","116475",2051373.000000000000000,2015969.000000000000000
"215","32",Kerala,"595",Ernakulam,"3282388","1619557","1662831","268411","16559","2234363","1048025","388973","198461","190512","30787","2265","265089","123884",3209549.000000000000000,3095808.000000000000000
"216","32",Kerala,"592",Malappuram,"4112920","1960328","2152592","308266","22990","1817211","2295709","667450","340608","326842","43983","3793","292268","375182",4328273.000000000000000,4185144.000000000465661
"217","27",Maharashtra,"531",Sangli,"2822143","1435728","1386415","353093","18333","719357","2102786","399721","216083","183638","52841","2983","99456","300265",3143588.000000000000000,3073251.000000000000000
"218","27",Maharashtra,"528",Ratnagiri,"1615069","761121","853948","66948","20374","263723","1351346","239861","122870","116991","9921","3784","36976","202885",1670689.000000000000000,1727932.000000000232831
"219","27",Maharashtra,"526",Solapur,"4317756","2227852","2089904","649745","77592","1399091","2918665","665681","353008","312673","105851","13650","209213","456468",4633428.000000000000000,4799994.000000000000000
"220","27",Maharashtra,"525",Osmanabad,"1657576","861535","796041","265184","36039","281057","1376519","256314","135684","120630","43065","6892","46471","209843",1814348.000000000232831,1869354.000000000000000
"221","27",Maharashtra,"524",Latur,"2454196","1273140","1181056","480913","57488","624980","1829216","406792","214402","192390","85261","10283","107387","299405",2721033.000000000000000,2794749.000000000000000
"222","27",Maharashtra,"513",Parbhani,"1836086","942870","893216","247308","40514","569806","1266280","311049","161952","149097","44355","7556","97162","213887",1963329.000000000000000,1987837.000000000000000
"223","27",Maharashtra,"521",Pune,"9429408","4924105","4505303","1180703","348876","5751182","3678226","1234374","654712","579662","174876","57610","715383","518991",10006915.000000000000000,10239918.000000000000000
"224","27",Maharashtra,"520",Raigarh,"2634200","1344345","1289855","134952","305125","970195","1664005","376530","195608","180922","19471","55266","132022","244508",2746638.000000000000000,2827840.000000000000000
"225","27",Maharashtra,"517",Thane,"11060148","5865078","5195070","730089","1542451","8514678","2545470","1575655","827273","748382","103267","302245","1140490","435165",12186122.000000000000000,11961108.000000000000000
"226","27",Maharashtra,"519",Mumbai,"3085411","1684608","1400803","219934","25093","3085411","0","355284","187187","168097","27090","3272","355284","0",3006364.000000000000000,2856935.999999999534339
"227","27",Maharashtra,"512",Hingoli,"1177345","606294","571051","182565","111954","178733","998612","204052","106573","97479","32651","21889","32314","171738",1240693.000000000000000,1332646.000000000000000
"228","27",Maharashtra,"502",Washim,"1197160","620302","576858","229462","80471","211413","985747","198838","104684","94154","39605","15638","34882","163956",1109618.000000000000000,1161181.000000000000000
"229","27",Maharashtra,"506",Bhandara,"1200334","605520","594814","200372","88886","233831","966503","171748","87807","83941","27464","14372","31898","139850",1502291.999999999767169,1480730.000000000000000
"230","27",Maharashtra,"503",Amravati,"2888445","1480768","1407677","506374","404128","1037287","1851158","426069","219401","206668","72273","82440","145087","280982",2938071.000000000000000,3104372.000000000000000
"231","27",Maharashtra,"499",Jalgaon,"4229917","2197365","2032552","389273","604367","1342711","2887206","657226","354542","302684","62739","117416","197402","459824",4243071.000000000000000,4407946.000000000000000
"232","27",Maharashtra,"508",Gadchiroli,"1072942","541328","531614","120745","415306","118033","954909","176228","90398","85830","17698","80027","17803","158425",1123666.000000000000000,1160995.000000000000000
"233","27",Maharashtra,"530",Kolhapur,"3876001","1980658","1895343","504461","30206","1230009","2645992","524748","285252","239496","71808","4407","161995","362753",3884739.000000000000000,4222192.000000000000000
"234","27",Maharashtra,"509",Chandrapur,"2204307","1123834","1080473","348365","389441","775378","1428929","307783","159180","148603","46973","58878","105000","202783",2278710.000000000000000,2348831.000000000000000
"235","27",Maharashtra,"505",Nagpur,"4653570","2384975","2268595","867713","437571","3178759","1474811","626927","324229","302698","114399","65061","420967","205960",4938418.000000000000000,5089994.999999999068677
"236","14",Manipur,"274",Churachandpur,"274143","138820","135323","443","254787","18357","255786","46445","23795","22650","82","43988","2839","43606",283076.000000000000000,327938.000000000000000
"237","14",Manipur,"276",Thoubal,"422168","210845","211323","40593","1808","151333","270835","75556","38431","37125","6375","246","25417","50139",431938.000000000000000,455828.000000000000000
"238","14",Manipur,"279",Ukhrul,"183998","94718","89280","248","173606","27187","156811","34454","17950","16504","33","33033","5494","28960",191927.000000000000000,202045.000000000000000
"239","14",Manipur,"272",Senapati,"479148","247323","231825","1000","419210","7476","471672","92239","48435","43804","211","80327","1367","90872",197251.000000000000000,478310.000000000000000
"240","14",Manipur,"277",Imphal West,"517992","255054","262938","16530","24161","322879","195113","76053","38764","37289","2545","3764","44666","31387",622527.000000000000000,633150.000000000116415
"241","14",Manipur,"278",Imphal East,"456113","226094","230019","15839","27657","183207","272906","73016","36845","36171","2875","4560","26529","46487",470866.000000000000000,476660.000000000000000
"242","2",Himachal Pradesh,"25",Lahul & Spiti,"31564","16588","14976","2235","25707","0","31564","4120","2050","2070","268","3575","0","4120",33159.000000000000000,34372.000000000000000
"243","2",Himachal Pradesh,"23",Chamba,"519080","261320","257760","111690","135500","36108","482972","88360","45246","43114","20149","23612","5557","82803",532868.000000000000000,543291.000000000000000
"244","2",Himachal Pradesh,"29",Una,"521173","263692","257481","115491","8601","44913","476260","76089","41369","34720","17945","1452","6245","69844",503858.000000000000000,575269.000000000000000
"245","2",Himachal Pradesh,"26",Kullu,"437903","225452","212451","122659","16822","41391","396512","65485","33451","32034","20108","2196","5341","60144",490286.000000000000000,451711.000000000058208
"246","2",Himachal Pradesh,"33",Shimla,"814010","425039","388971","215777","8755","201351","612659","111638","58292","53346","33298","1527","26141","85497",858620.000000000000000,862739.000000000000000
"247","2",Himachal Pradesh,"24",Kangra,"1510075","750591","759484","319385","84564","86281","1423794","209917","113941","95976","47384","12652","11899","198018",1617695.000000000000000,1587607.000000000000000
"248","15",Mizoram,"286",Lunglei,"161428","82891","78537","178","153533","68752","92676","29047","14858","14189","30","28264","11043","18004",160171.000000000000000,174854.000000000000000
"249","15",Mizoram,"282",Kolasib,"83955","42918","41037","84","73609","46878","37077","14541","7397","7144","12","12637","7807","6734",63621.000000000000000,105504.000000000000000
"250","15",Mizoram,"284",Champhai,"125745","63388","62357","17","123466","48529","77216","22462","11339","11123","0","22113","8146","14316",158384.000000000000000,145206.000000000000000
"251","6",Haryana,"78",Fatehabad,"942011","495360","446651","284357","0","179588","762423","155780","84880","70900","53778","0","27428","128352",1198316.000000000232831,1087882.000000000000000
"252","6",Haryana,"80",Hisar,"1743931","931562","812369","408785","0","553488","1190443","282090","153990","128100","76403","0","82320","199770",1623405.000000000000000,1897333.000000000000000
"253","6",Haryana,"85",Rewari,"900332","474335","425997","182606","0","233430","666902","140517","78369","62148","31741","0","35922","104595",897096.000000000000000,1014709.000000000000000
"254","17",Meghalaya,"294",East Garo Hills,"317917","161223","156694","509","305180","44192","273725","65596","33439","32157","88","63347","8765","56831",226430.000000000000000,322018.000000000000000
"255","17",Meghalaya,"293",West Garo Hills,"643291","324159","319132","8810","474009","74858","568433","129602","65603","63999","1622","95519","12955","116647",657886.000000000116415,776409.999999999883585
"256","17",Meghalaya,"296",West Khasi Hills,"383461","193715","189746","168","375097","43105","340356","85834","43527","42307","20","84253","9764","76070",420280.999999999941792,482884.999999999941792
"257","17",Meghalaya,"298",East Khasi Hills,"825922","410749","415173","5642","661158","366481","459441","154630","78038","76592","1023","131476","57061","97569",730523.000000000000000,937876.000000000000000
"258","16",Tripura,"289",West Tripura,"1725739","879428","846311","338094","431944","677638","1048101","241055","123065","117990","48263","69332","81600","159455",1938863.000000000000000,1806969.000000000000000
"259","16",Tripura,"292",North Tripura,"693947","352860","341087","114968","179426","120285","573662","113454","57698","55756","18340","34474","15826","97628",504415.000000000058208,667209.999999999883585
"260","12",Arunachal Pradesh,"246",West Kameng,"83947","46155","37792","0","46380","15932","68015","14634","7300","7334","0","9411","2827","11807",73841.000000000000000,93777.000000000000000
"261","12",Arunachal Pradesh,"250",West Siang,"112274","58168","54106","0","92783","24968","87306","22759","11387","11372","0","19824","4563","18196",137943.000000000000000,124228.000000000000000
"262","12",Arunachal Pradesh,"249",Upper Subansiri,"83448","41758","41690","0","78323","13405","70043","18419","9418","9001","0","17616","2905","15514",83130.000000000000000,95466.000000000000000
"263","12",Arunachal Pradesh,"248",Papum PAre,"176573","89182","87391","0","117216","96963","79610","35072","17329","17743","0","25876","17683","17389",158678.000000000000000,179146.000000000000000
"264","12",Arunachal Pradesh,"253",Changlang,"148226","76948","71278","0","53878","19228","128998","29005","14789","14216","0","10455","3297","25708",164750.000000000000000,155088.000000000000000
"265","12",Arunachal Pradesh,"251",East Siang,"99214","50116","49098","0","69979","27635","71579","19145","9675","9470","0","13650","5323","13822",126786.000000000000000,112228.000000000000000
"266","12",Arunachal Pradesh,"254",Tirap,"111975","57604","54371","0","98372","20810","91165","23550","12093","11457","0","21581","3899","19651",111505.000000000000000,117465.000000000000000
"267","12",Arunachal Pradesh,"258",Lower Dibang Valley,"54080","28053","26027","0","25974","11389","42691","10882","5520","5362","0","5630","2451","8431",70196.000000000000000,63596.000000000000000
"268","18",Assam,"317",Karimganj,"1228686","625864","602822","157890","1940","109700","1118986","230191","116995","113196","27858","378","14773","215418",1315106.000000000000000,1426181.000000000000000
"269","18",Assam,"318",Hailakandi,"659296","337890","321406","70659","691","48140","611156","127560","64335","63225","12503","119","6630","120930",644687.000000000000000,788025.000000000000000
"270","18",Assam,"313",Golaghat,"1066888","543161","523727","62298","111765","97736","969152","181521","92439","89082","10629","20479","13495","168026",1204513.000000000000000,1169203.000000000000000
"271","18",Assam,"305",Nagaon,"2823768","1439112","1384656","266350","115153","369534","2454234","545456","276993","268463","45618","20563","52796","492660",2755012.000000000000000,2737614.000000000000000
"272","18",Assam,"322",Kamrup Metropolitan,"1253938","647585","606353","101789","75121","1037011","216927","168812","86535","82277","15792","10999","132486","36326",1645424.000000000000000,1426853.000000000000000
"273","18",Assam,"306",Sonitpur,"1924110","983904","940206","109130","232207","173845","1750265","341869","173590","168279","18424","43121","22950","318919",1982016.000000000000000,2084899.999999999767169
"274","18",Assam,"326",Udalguri,"831668","421617","410051","37844","267372","37574","794094","147992","75181","72811","6642","44919","5461","142531",980149.000000000000000,774556.000000000000000
"275","18",Assam,"325",Darrang,"928500","475273","453227","40260","8419","55494","873006","181983","93498","88485","6940","1412","8115","173868",857515.000000000000000,1031223.000000000000000
"276","18",Assam,"324",Baksa,"950075","481330","468745","73083","331007","12242","937833","165784","84368","81416","13048","56343","2022","163762",1204627.000000000000000,950568.000000000000000
"277","18",Assam,"323",Nalbari,"771639","396006","375633","60216","23364","82730","688909","126462","64548","61914","9558","3898","11197","115265",997553.999999999883585,800270.000000000116415
"278","18",Assam,"320",Chirang,"482162","244860","237302","35135","178688","35337","446825","91933","46979","44954","6851","33163","5445","86488",1092855.000000000000000,457000.000000000000000
"279","18",Assam,"301",Dhubri,"1949258","997848","951410","70395","6332","203701","1745557","388594","200577","188017","11674","985","29849","358745",1777939.999999999767169,2066422.000000000000000
"280","10",Bihar,"207",Madhubani,"4487379","2329313","2158066","587158","3990","161495","4325884","987366","513823","473543","139134","845","32308","955058",6268965.000000000000000,5404565.000000000931323
"281","10",Bihar,"211",Purnia,"3264619","1699370","1565249","390991","139490","343005","2921614","724514","376426","348088","89896","31111","66065","658449",3512870.000000000000000,3842872.000000000465661
"282","10",Bihar,"216",Muzaffarpur,"4801062","2527497","2273565","751975","5979","473437","4327625","1001660","525873","475787","165944","1178","83705","917955",5152897.000000000000000,5510000.000000000931323
"283","10",Bihar,"219",Saran,"3951862","2022821","1929041","474066","36786","353202","3598660","865403","446378","419025","109911","8524","69994","795409",3816059.000000000000000,4618484.000000000000000
"284","10",Bihar,"226",Munger,"1367765","729041","638724","183846","21404","380120","987645","278078","147948","130130","40056","4823","68639","209439",1377767.000000000000000,1595203.000000000000000
"285","10",Bihar,"231",Bhojpur,"2728407","1430380","1298027","425402","13977","389861","2338546","572997","301958","271039","94258","3129","76224","496773",3015658.000000000000000,3261483.000000000000000
"286","10",Bihar,"233",Kaimur,"1626384","847006","779378","369088","57981","65571","1560813","355781","186270","169511","85072","13065","13689","342092",1646505.000000000000000,1791308.000000000232831
"287","10",Bihar,"234",Rohtas,"2959918","1543546","1416372","549546","31650","427765","2532153","634058","330453","303605","125181","7339","86117","547941",2962371.000000000000000,3388506.000000000000000
"288","10",Bihar,"236",Gaya,"4391418","2266566","2124852","1334351","3098","581601","3809817","933465","483619","449846","300594","613","105156","828309",4393721.000000000000000,4911158.000000000000000
"289","10",Bihar,"237",Nawada,"2219146","1144668","1074478","565112","2045","215579","2003567","491979","255859","236120","132247","461","44847","447132",2202916.000000000000000,2561517.000000000000000
"290","10",Bihar,"238",Jamui,"1760405","916064","844341","302649","78793","145333","1615072","370507","194211","176296","65300","17419","28682","341825",1877676.000000000232831,1977082.000000000000000
"291","10",Bihar,"240",Arwal,"700843","363497","337346","141314","590","51849","648994","150440","78351","72089","31749","111","11055","139385",663444.000000000000000,834238.000000000116415
"292","10",Bihar,"203",Pashchim Champaran,"3935042","2061110","1873932","553944","250046","393165","3541877","876364","458204","418160","125376","55321","80294","796070",4380622.000000000000000,4487923.000000000000000
"293","10",Bihar,"204",Purba Champaran,"5099371","2681209","2418162","649726","12461","401343","4698028","1140845","603303","537542","148955","2785","82834","1058011",5959618.000000000000000,5936500.000000000000000
"294","10",Bihar,"209",Araria,"2811569","1463333","1348236","382654","38848","168777","2642792","639901","332018","307883","89326","8740","34653","605248",3741815.000000000000000,3393405.000000000000000
"295","30",Goa,"586",South Goa,"640537","322463","318074","7843","92669","413733","226804","79244","40879","38365","1063","12226","51743","27501",849376.000000000000000,648507.000000000000000
"296","24",Gujarat,"491",Valsad,"1705678","887222","818456","38237","902794","635501","1070177","265766","139145","126621","5110","154732","89457","176309",1753840.000000000000000,1927809.000000000000000
"297","24",Gujarat,"490",Navsari,"1329672","678165","651507","35464","639659","409137","920535","179763","94133","85630","4334","92865","52528","127235",1240586.000000000000000,1465786.000000000000000
"298","24",Gujarat,"493",Tapi,"807022","402188","404834","8168","679320","79487","727535","120481","61712","58769","1212","102212","11297","109184",1061317.000000000000000,860854.000000000116415
"299","24",Gujarat,"492",Surat,"6081322","3402224","2679098","158115","856952","4849213","1232109","852712","470804","381908","22473","137317","668042","184670",6166690.000000000000000,6678300.000000000000000
"300","24",Gujarat,"487",Narmada,"590297","301086","289211","8733","481392","61872","528425","104489","54249","50240","1100","89466","9704","94785",435072.999999999941792,652358.000000000116415
"301","24",Gujarat,"488",Bharuch,"1551019","805707","745312","62235","488194","524959","1026060","241954","127278","114676","8676","83927","77379","164575",1930357.000000000000000,1729419.000000000000000
"302","24",Gujarat,"486",Vadodara,"4165626","2153736","2011890","221629","1149901","2065771","2099855","622331","333190","289141","30935","208188","274645","347686",4318913.000000000000000,4619711.000000000000000
"303","24",Gujarat,"485",Dohad,"2127086","1068651","1058435","41444","1580850","191625","1935461","442783","224889","217894","8091","344628","32075","410708",1705059.999999999767169,2341103.000000000000000
"304","24",Gujarat,"484",Panch Mahals,"2390776","1226961","1163815","100446","721604","334827","2055949","428244","222666","205578","16324","145400","54249","373995",3022342.000000000000000,2642503.000000000000000
"305","24",Gujarat,"483",Kheda,"2299885","1185727","1114158","115631","40336","523609","1776276","366822","196755","170067","17379","7462","76865","289957",2260143.000000000000000,2541018.000000000000000
"306","24",Gujarat,"472",Sabar Kantha,"2428589","1244231","1184358","187685","542156","363720","2064869","407249","216887","190362","29333","110380","57353","349896",2549145.000000000000000,2706000.000000000000000
"307","24",Gujarat,"473",Gandhinagar,"1391753","723864","667889","108608","18204","600627","791126","207936","114920","93016","15035","2939","84124","123812",2245431.000000000000000,1493994.000000000000000
"308","24",Gujarat,"474",Ahmadabad,"7214225","3788051","3426174","759483","89138","6063047","1151178","1043285","572422","470863","111189","14557","845160","198125",7418578.000000000000000,8020084.000000000000000
"309","24",Gujarat,"481",Bhavnagar,"2880365","1490201","1390164","157034","9110","1182401","1697964","500517","266465","234052","27187","1585","185343","315174",2636240.000000000000000,3161172.000000000000000
"310","24",Gujarat,"480",Amreli,"1514190","771049","743141","132915","7322","386635","1127555","242875","128111","114764","24074","1254","60634","182241",1938234.000000000000000,1155083.000000000000000
"311","24",Gujarat,"479",Junagadh,"2743082","1404356","1338726","265793","55571","906412","1836670","456199","240065","216134","48849","10302","145208","310991",2832657.000000000000000,3594676.000000000000000
"312","24",Gujarat,"475",Surendranagar,"1756268","909917","846351","179461","21453","496916","1259352","307016","164109","142907","30915","4650","76064","230952",1834591.000000000000000,1914636.000000000232831
"313","24",Gujarat,"471",Mahesana,"2035064","1056520","978544","162288","9392","514330","1520734","313202","174133","139069","25546","1543","73466","239736",1979390.000000000000000,2259152.000000000000000
"314","24",Gujarat,"470",Patan,"1343734","694397","649337","123408","13303","281081","1062653","233541","125446","108095","21938","2529","42581","190960",1188419.999999999767169,1500209.000000000000000
"315","24",Gujarat,"0",Null,,,,,,,,,,,,,,,,
"316","24",Gujarat,"469",Banas Kantha,"3120506","1610379","1510127","327460","284155","414915","2705591","609839","321682","288157","65582","66217","71087","538752",2987182.000000000000000,3431335.999999999534339
"317","33",Tamil Nadu,"629",Kanniyakumari,"1870374","926345","944029","74249","7282","1539802","330572","235470","119260","116210","9545","1022","193572","41898",2034272.000000000000000,2032993.000000000000000
"318","24",Gujarat,"468",Kachchh,"2092371","1096737","995634","258859","24228","728535","1363836","355116","186119","168997","48788","4570","112363","242753",2169025.000000000000000,2288438.000000000000000
"319","20",Jharkhand,"346",Garhwa,"1322784","683575","639209","319946","205874","69670","1253114","299921","153392","146529","74662","49814","13468","286453",1456079.000000000000000,1425177.000000000000000
"320","20",Jharkhand,"358",Palamu,"1939869","1006302","933567","536382","181208","226003","1713866","422981","216849","206132","123969","43494","42365","380616",1848641.000000000000000,2266512.000000000000000
"321","12",Arunachal Pradesh,"255",Lower Subansiri,"83030","41843","41187","0","72911","12806","70224","16748","8575","8173","0","15127","2476","14272",132417.000000000000000,103626.000000000000000
"322","10",Bihar,"214",Saharsa,"1900661","997174","903487","317249","6009","156540","1744121","421013","224526","196487","74857","1391","30663","390350",1634050.000000000000000,2083346.000000000000000
"323","10",Bihar,"221",Samastipur,"4261566","2230003","2031563","803128","1884","147797","4113769","941155","492531","448624","186215","393","28334","912821",3756147.000000000000000,4475787.000000000000000
"324","10",Bihar,"222",Begusarai,"2970541","1567660","1402881","432270","1597","569823","2400718","663462","348703","314759","101158","328","119333","544129",2853048.000000000465661,3434652.000000000000000
"325","36",Telangana,"537",Rangareddy,"5296741","2701008","2595733","101306","218757","3719172","1577569","761333","390500","370833","101306","43536","505326","256007",9713782.000000000000000,9729534.000000000000000
"326","10",Bihar,"228",Sheikhpura,"636342","329743","306599","131115","617","109002","527340","140670","73680","66990","30572","156","23574","117096",466176.999999999941792,624086.000000000116415
"327","33",Tamil Nadu,"618",Nagapattinam,"1616450","798127","818323","509767","3756","364624","1251826","225999","114012","111987","82776","715","50048","175951",1629569.000000000000000,1698861.000000000000000
"328","20",Jharkhand,"347",Chatra,"1042886","533935","508951","340553","45563","62954","979932","233874","119716","114158","80199","11002","12763","221111",1150349.000000000000000,1269059.999999999767169
"329","20",Jharkhand,"351",Godda,"1313551","677927","635624","115567","279208","64419","1249132","265529","137926","127603","24800","53825","11808","253721",1414399.000000000000000,1473059.000000000000000
"330","24",Gujarat,"489",The Dangs,"228291","113821","114470","992","216073","24687","203604","47890","24431","23459","152","45856","5500","42390",229270.000000000000000,247767.000000000000000
"331","33",Tamil Nadu,"623",Madurai,"3038252","1526475","1511777","408976","11096","1846801","1191451","409327","212754","196573","61675","1765","239321","170006",2970322.000000000000000,3275769.000000000000000
"332","20",Jharkhand,"352",Sahibganj,"1150567","589391","561176","72341","308343","159666","990901","241257","124549","116708","14767","60532","30048","211209",1206778.000000000000000,1278337.000000000000000
"333","33",Tamil Nadu,"622",Sivaganga,"1339101","668672","670429","227746","790","412845","926256","182896","93741","89155","33389","137","56500","126396",1460197.000000000000000,1454385.000000000000000
"334","33",Tamil Nadu,"620",Thanjavur,"2405890","1182416","1223474","455062","3561","851359","1554531","327162","166707","160455","72631","627","110262","216900",2646734.000000000000000,2597750.000000000000000
"335","24",Gujarat,"476",Rajkot,"3804558","1974445","1830113","290169","24017","2214050","1590508","561059","302997","258062","48176","4143","310821","250238",4005830.000000000000000,4218987.000000000000000
"336","33",Tamil Nadu,"612",Dindigul,"2159775","1080938","1078837","452376","8064","808040","1351735","288183","149250","138933","64878","1533","107467","180716",2188757.000000000000000,2276462.000000000000000
"337","7",NCT of Delhi,"90",North West,"3656539","1960922","1695617","697237","0","3442589","213950","579669","315573","264096","119391","0","542120","37549",3070934.000000000000000,4100643.000000000000000
"338","20",Jharkhand,"364",Ranchi,"2914253","1494937","1419316","152943","1042016","1257335","1656918","527727","270073","257654","29375","203405","196990","330737",2855117.000000000000000,3319756.000000000000000
"339","33",Tamil Nadu,"628",Tirunelveli,"3077233","1520912","1556321","569714","10270","1520229","1557004","424577","216914","207663","81711","1695","204806","219771",3119680.000000000000000,3260542.000000000000000
"340","11",Sikkim,"242",West District,"136435","70238","66197","5935","57817","5248","131187","25711","13083","12628","1248","11101","856","24855",149344.000000000000000,151704.000000000000000
"341","33",Tamil Nadu,"627",Thoothukkudi,"1750176","865021","885155","347895","4911","876802","873374","244712","124600","120112","52272","891","121718","122994",2264417.000000000000000,1962018.000000000000000
"342","21",Odisha,"391",Baudh,"441162","221625","219537","104934","55364","20424","420738","80044","40418","39626","19575","10491","3198","76846",649272.000000000000000,519367.000000000058208
"343","10",Bihar,"224",Bhagalpur,"3037766","1615663","1422103","318569","67180","602532","2435234","644845","339007","305838","72047","15225","113578","531267",2701383.000000000000000,3476641.000000000000000
"344","10",Bihar,"229",Nalanda,"2877653","1497060","1380593","607672","1442","457894","2419759","612820","321064","291756","139958","310","93451","519369",2857543.999999999534339,3284826.000000000000000
"345","20",Jharkhand,"349",Giridih,"2445474","1258098","1187376","325493","238188","208024","2237450","514327","263953","250374","70396","52603","38257","476070",2571175.000000000000000,2719653.000000000000000
"346","20",Jharkhand,"350",Deoghar,"1492073","775022","717051","190036","180962","258361","1233712","295681","153107","142574","37912","35769","45564","250117",1523297.000000000000000,1624818.000000000000000
"347","29",Karnataka,"568",Shimoga,"1752753","877415","875338","308158","65412","623727","1129026","247017","126168","120849","47807","9783","86123","160894",1977659.000000000000000,1904042.000000000000000
"348","33",Tamil Nadu,"616",Ariyalur,"754894","374703","380191","176230","10722","83794","671100","109418","56367","53051","29820","1925","11967","97451",547838.000000000000000,814241.000000000000000
"349","33",Tamil Nadu,"615",Perambalur,"565223","282157","283066","175289","2584","97163","468060","82408","43158","39250","26896","450","13783","68625",519795.000000000058208,629571.000000000000000
"350","33",Tamil Nadu,"617",Cuddalore,"2605914","1311697","1294217","763944","15702","885189","1720725","367895","188945","178950","124188","2925","119174","248721",2987343.000000000000000,2804341.000000000000000
"351","10",Bihar,"208",Supaul,"2229076","1155283","1073793","354249","10168","105558","2123518","506867","263895","242972","84144","2450","22020","484847",2732913.000000000000000,2642170.000000000000000
"352","6",Haryana,"86",Gurgaon,"1514432","816690","697742","197937","0","1042253","472179","223785","123808","99977","34550","0","146002","77783",1809997.000000000000000,1740167.000000000000000
"353","33",Tamil Nadu,"613",Karur,"1064493","528184","536309","221385","575","434517","629976","136636","71040","65596","31065","81","54672","81964",1670335.000000000000000,1130388.000000000000000
"354","20",Jharkhand,"360",Hazaribagh,"1734495","890881","843614","303515","121768","275307","1459188","357426","181924","175502","65997","26389","49055","308371",1744981.000000000000000,2008691.999999999767169
"355","21",Odisha,"393",Balangir,"1648997","830097","818900","294777","347164","197381","1451616","261095","131181","129914","49283","59088","27619","233476",1764130.000000000000000,1737360.000000000000000
"356","21",Odisha,"370",Bargarh,"1481255","749161","732094","298780","281135","150110","1331145","210489","106406","104083","45788","45074","21216","189273",1209944.000000000000000,1536406.000000000000000
"357","32",Kerala,"590",Wayanad,"817420","401684","415736","32578","151443","31580","785840","119922","61205","58717","4739","25716","4571","115351",860001.999999999883585,840471.000000000000000
"358","21",Odisha,"376",Mayurbhanj,"2519738","1256213","1263525","184682","1479576","192896","2326842","455365","230412","224953","31573","294067","28072","427293",2801147.000000000000000,2769949.000000000000000
"359","27",Maharashtra,"511",Nanded,"3361292","1730075","1631217","640483","281695","913898","2447394","580810","302922","277888","112864","54776","155170","425640",3646030.000000000000000,3697071.000000000000000
"360","30",Goa,"585",North Goa,"818008","416677","401331","17606","56606","493081","324927","94305","48767","45538","2187","6793","56951","37354",664151.000000000000000,829390.000000000116415
"361","27",Maharashtra,"504",Wardha,"1300774","668385","632389","188830","149507","423300","877474","173892","90319","83573","24162","22526","54780","119112",1424686.000000000000000,1458841.000000000000000
"362","27",Maharashtra,"500",Buldana,"2586258","1337560","1248698","470895","124837","548860","2037398","409658","216567","193091","78663","25581","85548","324110",2647301.000000000000000,2753346.000000000000000
"363","27",Maharashtra,"516",Nashik,"6107187","3157186","2950001","554687","1564369","2597373","3509814","987411","520488","466923","89097","303014","391626","595785",6412163.000000000000000,6620844.000000000000000
"364","6",Haryana,"74",Karnal,"1505324","797712","707612","339604","0","454810","1050514","237251","131758","105493","60083","0","65899","171352",1751619.999999999767169,1562951.000000000000000
"365","6",Haryana,"79",Sirsa,"1295189","682582","612607","387381","0","319248","975941","206807","113626","93181","73029","0","47570","159237",1327408.000000000000000,1420146.000000000000000
"366","7",NCT of Delhi,"98",South,"2731929","1467428","1264501","422926","0","2719736","12193","422557","227804","194753","70902","0","420466","2091",3229109.000000000000000,3135827.000000000000000
"367","20",Jharkhand,"367",Simdega,"599578","300309","299269","44674","424407","42944","556634","113571","57466","56105","8812","80204","8388","105183",722240.000000000000000,639900.000000000000000
"368","13",Nagaland,"263",Zunheboto,"140757","71217","69540","0","136561","27597","113160","28960","14811","14149","0","28512","5942","23018",163570.000000000000000,155963.000000000000000
"369","10",Bihar,"239",Jehanabad,"1125313","585582","539731","222974","1285","135196","990117","242641","127010","115631","51288","290","27867","214774",1082127.000000000000000,1349018.000000000000000
"370","36",Telangana,"533",Nizamabad,"2551335","1250641","1300694","58723","192941","588372","1962963","405657","206272","199385","58723","38369","94218","311439",2664060.000000000000000,2662487.000000000000000
"371","13",Nagaland,"269",Kiphire,"74004","37830","36174","0","71429","16487","57517","16589","8737","7852","0","16135","3861","12728",41998.000000000000000,63958.000000000000000
"372","20",Jharkhand,"348",Kodarma,"716259","367222","349037","109003","6903","141246","575013","147726","76195","71531","23067","1332","26927","120799",735515.000000000000000,699379.000000000000000
"373","8",Rajasthan,"130",Udaipur,"3068420","1566801","1501619","188525","1525289","608426","2459994","565834","295543","270291","32965","326342","86564","479270",2879476.000000000000000,3451111.999999999534339
"374","8",Rajasthan,"122",Bhilwara,"2408523","1220736","1187787","407947","229273","512654","1895869","432489","223646","208843","78817","43997","83964","348525",2441284.000000000000000,2624429.000000000000000
"375","20",Jharkhand,"361",Ramgarh,"949443","494230","455213","106356","201166","418955","530488","182531","93342","89189","21479","41693","75886","106645",1028063.000000000000000,1075703.000000000000000
"376","10",Bihar,"230",Patna,"5838465","3078512","2759953","920918","9069","2514590","3323875","1153689","609728","543961","201417","1480","446787","706902",6298210.000000000000000,6713914.000000000000000
"377","11",Sikkim,"244",East District,"283583","151432","132151","15305","78436","122487","161096","42811","21726","21085","2499","12103","17134","25677",312054.000000000000000,250600.000000000000000
"378","11",Sikkim,"241",North District,"43709","24730","18979","982","28715","4644","39065","7512","3690","3822","169","5561","968","6544",56748.000000000000000,45527.000000000000000
"379","11",Sikkim,"243",South District,"146850","76670","70180","6053","41392","21199","125651","25792","13078","12714","1130","7401","3355","22437",149990.000000000000000,209833.000000000000000
"380","8",Rajasthan,"113",Jodhpur,"3687165","1923928","1763237","608024","118924","1264614","2422551","735675","386022","349653","134613","28328","207366","528309",3852399.000000000000000,4121957.000000000000000
"381","8",Rajasthan,"116",Jalor,"1828730","936634","892096","357196","178719","151755","1676975","390031","204304","185727","79933","41809","29273","360758",1924537.000000000000000,2046885.000000000000000
"382","20",Jharkhand,"354",Dhanbad,"2684487","1405956","1278531","437309","233119","1560394","1124093","493491","255323","238168","87864","46382","274473","219018",1973905.000000000000000,2888389.000000000000000
"383","8",Rajasthan,"129",Jhalawar,"1411129","725143","685986","243582","182229","229291","1181838","257143","134190","122953","46531","37288","38318","218825",1475624.000000000000000,1624337.000000000000000
"384","13",Nagaland,"270",Kohima,"267988","138966","129022","0","224738","121088","146900","49405","25178","24227","0","43618","21160","28245",241262.000000000000000,257816.000000000000000
"385","8",Rajasthan,"119",Ajmer,"2583052","1324085","1258967","478027","63482","1035410","1547642","458166","239822","218344","86882","12289","158227","299939",2759852.000000000000000,2934648.000000000465661
"386","8",Rajasthan,"106",Dhaulpur,"1206516","653647","552869","245695","58594","247450","959066","262465","144112","118353","55182","13188","50080","212385",1251992.000000000000000,1339909.000000000000000
"387","8",Rajasthan,"104",Alwar,"3674179","1939026","1735153","653036","289249","654451","3019728","708523","380241","328282","133308","57563","107880","600643",3864522.000000000000000,4122935.000000000000000
"388","8",Rajasthan,"111",Sikar,"2677333","1374990","1302343","418806","75349","633906","2043427","500695","266827","233868","85517","14614","113483","387212",2813431.000000000000000,2988151.000000000000000
"389","8",Rajasthan,"112",Nagaur,"3307743","1696325","1611418","699911","10418","637204","2670539","651057","340527","310530","150910","2177","122475","528582",3467005.000000000000000,3694383.000000000000000
"390","8",Rajasthan,"101",Bikaner,"2363937","1240801","1123136","493646","7779","800384","1563553","481310","252617","228693","110976","1539","134228","347082",2889674.000000000000000,2688076.000000000000000
"391","8",Rajasthan,"114",Jaislamer,"669919","361708","308211","99134","42429","89025","580894","143842","77907","65935","22723","9992","15970","127872",708552.000000000000000,757847.000000000000000
"392","8",Rajasthan,"115",Barmer,"2603751","1369022","1234729","436414","176257","181837","2421914","566383","298294","268089","100372","40426","32150","534233",2672423.000000000000000,2861921.000000000000000
"393","8",Rajasthan,"124",Dungarpur,"1388552","696532","692020","52267","983437","88743","1299809","276841","143229","133612","10165","211366","14708","262133",1394429.000000000000000,1499263.000000000000000
"394","8",Rajasthan,"125",Banswara,"1797485","907754","889731","80091","1372999","127621","1669864","361336","186012","175324","16120","291800","20095","341241",1674718.000000000000000,1939551.000000000000000
"395","8",Rajasthan,"131",Pratapgarh,"867848","437744","430104","60429","550427","71807","796041","167924","86253","81671","10974","116110","11037","156887",956769.999999999883585,977456.000000000000000
"396","8",Rajasthan,"126",Chittaurgarh,"1544338","783171","761167","250224","201546","285264","1259074","255637","133721","121916","43824","36955","45274","210363",1895119.000000000000000,1779308.000000000232831
"397","8",Rajasthan,"127",Kota,"1951014","1021161","929853","405408","183816","1176604","774410","319155","168972","150183","72946","32304","179541","139614",2223290.000000000000000,2222124.000000000000000
"398","8",Rajasthan,"121",Bundi,"1110906","577160","533746","210788","228549","222701","888205","204492","108257","96235","40463","43444","36924","167568",1211237.000000000000000,1209333.000000000000000
"399","8",Rajasthan,"120",Tonk,"1421326","728136","693190","287903","178207","317723","1103603","266683","139253","127430","56415","35957","56829","209854",1478869.000000000000000,1577857.000000000000000
"400","13",Nagaland,"261",Mon,"250260","131753","118507","0","238285","34444","215816","53159","28246","24913","0","51185","7336","45823",203701.000000000000000,248807.000000000000000
"401","8",Rajasthan,"109",Dausa,"1634409","857787","776622","354337","433344","201793","1432616","328914","174237","154677","74404","90579","36382","292532",1289346.000000000000000,1809354.000000000000000
"402","20",Jharkhand,"357",Purbi Singhbhum,"2293919","1176902","1117017","111414","653923","1274591","1019328","357793","185730","172063","18259","113697","186374","171419",2202652.000000000000000,2554136.000000000465661
"403","8",Rajasthan,"100",Hanumangarh,"1774692","931184","843508","494189","14289","350464","1424228","313116","167258","145858","97532","2781","57927","255189",1753985.000000000000000,2003715.000000000000000
"404","3",Punjab,"37",Jalandhar,"2193590","1145211","1048379","854444","0","1161171","1032419","301237","166761","134476","127525","0","153878","147359",2367098.000000000000000,2359097.000000000000000
"405","3",Punjab,"38",Hoshiarpur,"1586625","809057","777568","557504","0","334969","1251656","224772","123861","100911","84673","0","43810","180962",1530538.000000000000000,1733063.000000000000000
"406","3",Punjab,"51",Rupnagar,"684627","357485","327142","180905","0","177807","506820","96815","53530","43285","28102","0","24096","72719",889320.000000000000000,778237.000000000000000
"407","19",West Bengal,"341",Haora,"4850029","2500819","2349210","718951","15094","3074144","1775885","682848","349949","332899","105601","2143","420369","262479",5131074.000000000000000,5154895.000000000000000
"408","3",Punjab,"42",Moga,"995746","525920","469826","363417","0","227246","768500","144175","79253","64922","63748","0","31953","112222",878457.999999999883585,1049346.000000000000000
"409","3",Punjab,"45",Faridkot,"617508","326671","290837","240328","0","217051","400457","88873","49217","39656","41348","0","30193","58680",563072.000000000000000,640310.000000000116415
"410","20",Jharkhand,"369",Saraikela-Kharsawan,"1065056","544411","520645","56195","374642","258746","806310","189707","97368","92339","10237","72162","42870","146837",1319827.999999999767169,1240775.000000000000000
"411","3",Punjab,"44",Muktsar,"901896","475622","426274","381554","0","252191","649705","132513","73410","59103","67288","0","36050","96463",947353.000000000000000,964149.000000000000000
"412","3",Punjab,"46",Bathinda,"1388525","743197","645328","450473","0","499217","889308","192692","107360","85332","76100","0","67452","125240",1041150.000000000116415,1488130.000000000000000
"413","3",Punjab,"53",Sangrur,"1655169","878029","777140","461609","0","515965","1139204","238635","133736","104899","78157","0","75153","163482",2350847.000000000000000,1735600.000000000000000
"414","3",Punjab,"54",Barnala,"595527","317522","278005","192001","0","190685","404842","86081","47897","38184","33583","0","27593","58488",761693.000000000000000,635875.000000000000000
"415","3",Punjab,"47",Mansa,"769751","408732","361019","258878","0","163604","606147","114941","64068","50873","46281","0","23627","91314",434068.999999999941792,835549.000000000000000
"416","3",Punjab,"43",Firozpur,"2029074","1071637","957437","855726","0","552556","1476518","318967","175774","143193","156722","0","79650","239317",2409319.999999999534339,2185371.000000000000000
"417","3",Punjab,"39",SBS Nagar,"612310","313291","299019","260284","0","125416","486894","84480","46649","37831","38564","0","17488","66992",712057.000000000000000,642319.000000000000000
"418","3",Punjab,"50",Tarn Taran,"1119627","589369","530258","377468","0","141795","977832","180768","101536","79232","72273","0","21606","159162",1265271.000000000000000,1189823.000000000000000
"419","3",Punjab,"35",Gurdaspur,"2298323","1212617","1085706","580576","0","659319","1639004","336472","188956","147516","95091","0","85153","251319",2399343.000000000000000,2467660.000000000000000
"420","21",Odisha,"392",Subarnapur,"610183","311312","298871","156219","57192","49941","560242","94931","47686","47245","25770","9823","7128","87803",549159.000000000000000,637288.000000000000000
"421","13",Nagaland,"268",Longleng,"50484","26502","23982","0","48615","7613","42871","10320","5427","4893","0","10026","1622","8698",66170.000000000000000,51863.000000000000000
"422","10",Bihar,"218",Siwan,"3330464","1675090","1655374","386685","87000","182913","3147551","732817","374761","358056","90939","20046","36379","696438",3340934.000000000000000,3704802.000000000000000
"423","21",Odisha,"371",Jharsuguda,"579505","296690","282815","104620","176758","231165","348340","84370","42479","41891","15567","28014","33424","50946",669816.000000000000000,613092.000000000000000
"424","20",Jharkhand,"365",Khunti,"531885","266335","265550","24037","389626","44982","486903","104032","52792","51240","4940","77452","8134","95898",775109.000000000000000,600364.000000000000000
"425","19",West Bengal,"332",Maldah,"3988845","2051541","1937304","835430","313984","541660","3447185","787275","400646","386629","155499","60476","84153","703122",4174777.000000000000000,4285585.000000000000000
"426","10",Bihar,"215",Darbhanga,"3937385","2059949","1877436","615688","2772","383328","3554057","856966","450843","406123","142495","608","73192","783774",4119918.000000000000000,4594917.000000000000000
"427","13",Nagaland,"262",Mokokchung,"194622","101092","93530","0","178431","55725","138897","33376","17479","15897","0","30952","9700","23676",212560.000000000000000,191595.000000000000000
"428","21",Odisha,"373",Debagarh,"312520","158230","154290","52112","110400","22390","290130","52033","26649","25384","8945","20544","3576","48457",369792.999999999941792,335882.000000000000000
"429","19",West Bengal,"339",Bankura,"3596674","1838095","1758579","1174447","368690","299773","3296901","549869","280762","269107","199167","58440","37992","511877",3879685.000000000000000,3933410.000000000000000
"430","19",West Bengal,"331",Dakshin Dinajpur,"1676276","857199","819077","482754","275366","236295","1439981","281710","143468","138242","83388","51941","31178","250532",1738563.000000000000000,1795155.000000000000000
"431","19",West Bengal,"342",Kolkata,"4496694","2356766","2139928","241932","10684","4496694","0","508907","265028","243879","31088","1280","508907","0",5585720.000000000000000,5261516.000000000000000
"432","20",Jharkhand,"355",Bokaro,"2062330","1072807","989523","299227","255626","983644","1078686","386563","197740","188823","59891","51791","168931","217632",3000386.000000000000000,2484400.000000000000000
"433","19",West Bengal,"330",Uttar Dinajpur,"3007134","1551066","1456068","807950","162816","362228","2644906","630092","322339","307753","155644","33599","63310","566782",3279833.000000000000000,3144353.000000000000000
"434","19",West Bengal,"328",Jalpaiguri,"3872846","1983064","1889782","1458278","731704","1060351","2812495","624486","317812","306674","241930","127850","151809","472677",4128199.000000000000000,4057817.000000000000000
"435","10",Bihar,"232",Buxar,"1706352","887977","818375","251737","26824","164499","1541853","361153","190341","170812","57052","6105","32371","328782",1822181.000000000000000,1955905.000000000000000
"436","9",Uttar Pradesh,"132",Saharanpur,"3466382","1834106","1632276","764450","980","1066526","2399856","676132","364180","311952","155704","221","190432","485700",3495190.000000000000000,3711063.000000000000000
"437","9",Uttar Pradesh,"134",Bijnor,"3682713","1921215","1761498","787444","3058","925312","2757401","749324","394407","354917","168608","775","178971","570353",4095478.000000000000000,4349083.000000000000000
"438","9",Uttar Pradesh,"133",Muzaffarnagar,"4143512","2193434","1950078","561250","317","1191312","2952200","837200","453312","383888","117579","53","225517","611683",4443172.000000000000000,4727262.000000000000000
"439","9",Uttar Pradesh,"139",Baghpat,"1303048","700070","602978","149060","14","275025","1028023","248584","135152","113432","29828","2","51997","196587",1408627.999999999767169,1498956.000000000232831
"440","9",Uttar Pradesh,"138",Meerut,"3443689","1825743","1617946","624149","3390","1759182","1684507","627715","340032","287683","118600","666","303712","324003",3490854.000000000000000,3717070.000000000000000
"441","9",Uttar Pradesh,"140",Ghaziabad,"4681645","2488834","2192811","773463","3968","3162547","1519098","832814","452511","380303","143596","674","535140","297674",3306279.999999999534339,5574327.000000000000000
"442","9",Uttar Pradesh,"141",GBN,"1648115","890214","757901","216105","2215","974309","673806","285923","155603","130320","42096","439","159369","126554",2328163.000000000000000,2013585.000000000000000
"443","9",Uttar Pradesh,"137",JPN,"1840221","963449","876772","318001","164","458713","1381508","393655","208583","185072","72555","39","90919","302736",2131602.000000000000000,1991233.000000000000000
"444","9",Uttar Pradesh,"145",Mathura,"2547184","1367125","1180059","506580","1520","755993","1791191","503766","272889","230877","106892","297","133763","370003",2204639.000000000000000,2708539.000000000000000
"445","9",Uttar Pradesh,"146",Agra,"4418797","2364953","2053844","991325","7255","2024195","2394602","885300","481659","403641","209306","1422","369320","515980",5030429.000000000000000,4708946.000000000000000
"446","9",Uttar Pradesh,"201",Etah,"1774480","947339","827141","281011","140","268142","1506338","374948","203563","171385","61896","28","50514","324434",2065683.000000000000000,2077835.000000000000000
"447","9",Uttar Pradesh,"202",KRN,"1436719","764165","672554","254299","150","288207","1148512","308889","165866","143023","57157","33","57165","251724",1451618.000000000000000,1692885.000000000000000
"448","9",Uttar Pradesh,"135",Moradabad,"4772006","2503186","2268820","731406","685","1573623","3198383","1020761","540163","480598","162439","118","298060","722701",4845098.999999999068677,5336247.000000000000000
"449","9",Uttar Pradesh,"136",Rampur,"2335819","1223889","1111930","307936","358","588647","1747172","515022","270498","244524","71461","64","113134","401888",2377945.000000000000000,2528227.000000000000000
"450","9",Uttar Pradesh,"152",Shahjahanpur,"3006538","1606403","1400135","532673","508","594092","2412446","648624","346326","302298","117963","94","110914","537710",3065372.000000000000000,3212623.000000000000000
"451","9",Uttar Pradesh,"147",Firozabad,"2498156","1332046","1166110","473890","2565","833169","1664987","521146","280717","240429","102740","638","165400","355746",2312335.000000000000000,2767582.000000000000000
"452","9",Uttar Pradesh,"148",Mainpuri,"1868529","993377","875152","368206","478","288442","1580087","384698","206947","177751","79705","121","54042","330656",1665912.000000000000000,2088721.000000000000000
"453","9",Uttar Pradesh,"154",Sitapur,"4483992","2375264","2108728","1446427","1602","530784","3953208","944574","500594","443980","309455","351","100776","843798",4568694.000000000000000,4816031.000000000000000
"454","9",Uttar Pradesh,"161",Etawah,"1581810","845856","735954","388283","169","366299","1215511","301686","161499","140187","78722","41","62849","238837",1682286.000000000000000,1756851.999999999767169
"455","9",Uttar Pradesh,"153",Kheri,"4021243","2123187","1898056","1061782","53375","461035","3560208","852823","451359","401464","229359","12291","85363","767460",4121037.000000000000000,4423040.000000000000000
"456","9",Uttar Pradesh,"160",Kannauj,"1656616","881776","774840","309980","15","280841","1375775","341711","181127","160584","67192","0","54003","287708",1629870.000000000000000,1768097.000000000000000
"457","9",Uttar Pradesh,"163",Kanpur Dehat,"1796184","963255","832929","460544","801","173423","1622761","340824","181585","159239","94065","191","31502","309322",1208390.000000000000000,1984605.000000000000000
"458","9",Uttar Pradesh,"166",Jhansi,"1998603","1057436","941167","562505","3873","833484","1165119","339054","181210","157844","100914","731","128684","210370",2106817.000000000000000,2241337.000000000000000
"459","9",Uttar Pradesh,"168",Hamirpur,"1104285","593537","510748","241198","474","209848","894437","213157","112928","100229","48825","112","37979","175178",1341466.000000000000000,1227957.000000000000000
"460","9",Uttar Pradesh,"156",Unnao,"3108367","1630087","1478280","948588","2926","531646","2576721","609083","319131","289952","197288","662","92496","516587",3010066.000000000000000,3217658.000000000000000
"461","9",Uttar Pradesh,"157",Lucknow,"4589838","2394476","2195362","948294","7506","3038996","1550842","771404","404153","367251","184871","1291","453750","317654",4742383.000000000000000,5052450.000000000000000
"462","9",Uttar Pradesh,"180",Bahraich,"3487731","1843884","1643847","509307","11159","284044","3203687","745527","397722","347805","107121","2539","54307","691220",3425603.000000000000000,3964103.999999999534339
"463","9",Uttar Pradesh,"181",Shrawasti,"1117361","593897","523464","189334","5534","38649","1078712","234331","126821","107510","38047","1299","7797","226534",1412709.000000000000000,1167032.000000000000000
"464","9",Uttar Pradesh,"172",Fatehpur,"2632733","1384722","1248011","651480","340","321993","2310740","534616","281307","253309","141399","71","57866","476750",2617360.000000000000000,2764181.000000000000000
"465","9",Uttar Pradesh,"170",Banda,"1799410","965876","833534","387855","163","275755","1523655","374860","198901","175959","84099","44","50579","324281",2003693.000000000000000,1942251.000000000000000
"466","9",Uttar Pradesh,"171",Chitrakoot,"991730","527721","464009","266655","366","96332","895398","215779","113567","102212","60971","84","18558","197221",1044201.000000000000000,1247467.000000000000000
"467","9",Uttar Pradesh,"199",Mirzapur,"2496970","1312302","1184668","661129","20132","347567","2149403","508310","267776","240534","142445","4443","62165","446145",2800346.000000000000000,2952438.000000000000000
"468","9",Uttar Pradesh,"198",SRNB,"1578213","807099","771114","353103","1873","229302","1348911","333310","175361","157949","77548","405","46333","286977",1790246.000000000000000,1786312.000000000000000
"469","9",Uttar Pradesh,"200",Sonbhadra,"1862559","971344","891215","421661","385018","314342","1548217","393422","203514","189908","91830","85680","55689","337733",1979823.000000000000000,2098662.000000000000000
"470","9",Uttar Pradesh,"196",Chandauli,"1952756","1017905","934851","446786","41725","242553","1710203","393790","206862","186928","93810","8443","46154","347636",2066767.000000000000000,2107996.000000000000000
"471","9",Uttar Pradesh,"197",Varanasi,"3676841","1921857","1754984","486958","28617","1597051","2079790","701669","368662","333007","99519","5883","275056","426613",3570246.000000000000000,4177355.000000000000000
"472","9",Uttar Pradesh,"173",Pratapgarh,"3209141","1606085","1603056","709252","723","175242","3033899","673798","349560","324238","160691","142","30925","642873",3283990.000000000000000,3566125.000000000000000
"473","9",Uttar Pradesh,"179",Sultanpur,"3797117","1914586","1882531","851587","696","199916","3597201","783205","404833","378372","181929","136","35661","747544",3991471.000000000000000,4245025.000000000000000
"474","9",Uttar Pradesh,"184",SID,"2559297","1295095","1264202","408763","12021","160691","2398606","566666","291946","274720","88125","2622","33020","533646",2310910.000000000000000,2848434.000000000000000
"475","9",Uttar Pradesh,"177",Faizabad,"2470996","1259628","1211368","555047","931","340253","2130743","495480","256185","239295","114413","195","55206","440274",3527969.000000000000000,2703177.000000000000000
"476","9",Uttar Pradesh,"182",Balrampur,"2148665","1114721","1033944","277212","24887","166391","1982274","475893","251047","224846","58837","5842","33407","442486",2209409.000000000000000,2266347.000000000000000
"477","9",Uttar Pradesh,"185",Basti,"2464464","1255272","1209192","513959","3620","138097","2326367","526012","271828","254184","112352","776","23591","502421",3430939.000000000000000,2941454.000000000000000
"478","9",Uttar Pradesh,"187",Maharajganj,"2684703","1381754","1302949","492976","16435","134730","2549973","575552","296807","278745","105540","3510","26088","549464",3084575.000000000000000,3018660.000000000000000
"479","9",Uttar Pradesh,"189",Kus,"3564544","1818055","1746489","544231","80269","168107","3396437","749501","386036","363465","115780","17168","31346","718155",3386041.000000000000000,3910482.000000000000000
"480","9",Uttar Pradesh,"186",SKN,"1715183","869656","845527","369039","1593","128531","1586652","371800","192372","179428","81248","360","25574","346226",1539989.000000000000000,1928411.000000000000000
"481","9",Uttar Pradesh,"188",Gorakhpur,"4440895","2277777","2163118","936061","18172","836129","3604766","880533","457816","422717","197089","3423","137804","742729",4578931.000000000000000,5032164.000000000000000
"482","9",Uttar Pradesh,"190",Deoria,"3100946","1537436","1563510","468663","109894","316803","2784143","646437","333170","313267","101622","24144","58869","587568",3340583.999999999534339,3285638.000000000000000
"483","9",Uttar Pradesh,"193",Ballia,"3239774","1672902","1566872","494698","110114","304109","2935665","651711","341789","309922","106286","23766","55902","595809",2891178.000000000000000,3442701.000000000000000
"484","9",Uttar Pradesh,"195",Ghazipur,"3620268","1855075","1765193","726641","28712","274360","3345908","738563","385304","353259","154370","5766","51065","687498",3516775.999999999534339,3806445.000000000000000
"485","9",Uttar Pradesh,"142",Bulandshahr,"3499171","1845260","1653911","725600","198","867429","2631742","686420","369877","316543","147606","45","161544","524876",4720210.000000000000000,3936378.000000000000000
"486","9",Uttar Pradesh,"165",Jalaun,"1689974","906092","783882","468178","832","418900","1271074","301229","161252","139977","87295","145","71750","229479",1777483.000000000000000,1871873.000000000000000
"487","9",Uttar Pradesh,"175",Allahabad,"5954391","3131807","2822584","1309851","7955","1472873","4481518","1187551","626174","561377","282596","1515","227087","960464",6051720.000000000000000,6879428.000000000000000
"488","9",Uttar Pradesh,"178",AMB,"2397888","1212410","1185478","591125","746","280730","2117158","491572","252762","238810","126005","130","54537","437035",2222715.000000000000000,2683567.000000000000000
"489","9",Uttar Pradesh,"143",Aligarh,"3673889","1951996","1721893","755254","629","1217191","2456698","740239","398208","342031","160126","134","227343","512896",3994587.000000000000000,4051665.000000000000000
"490","9",Uttar Pradesh,"149",Budaun,"3681896","1967759","1714137","622526","58","644595","3037301","810671","438167","372504","142071","17","131702","678969",3952166.000000000000000,4107507.000000000000000
"491","9",Uttar Pradesh,"150",Bareilly,"4448359","2357665","2090694","557150","3227","1568409","2879950","933808","496431","437377","121027","510","290656","643152",4906048.000000000000000,5146922.999999999068677
"492","9",Uttar Pradesh,"151",Pilibhit,"2031007","1072002","959005","333558","1714","351415","1679592","431675","226958","204717","73458","382","65193","366482",2127378.000000000000000,2329027.000000000000000
"493","9",Uttar Pradesh,"159",Farrukhabad,"1885204","1006240","878964","312712","230","416185","1469019","384797","206550","178247","66313","46","74211","310586",2039368.000000000000000,2104066.000000000000000
"494","9",Uttar Pradesh,"155",Hardoi,"4092845","2191442","1901403","1274505","349","541806","3551039","860872","456472","404400","274990","65","102569","758303",4300234.000000000000000,4595931.000000000000000
"495","9",Uttar Pradesh,"162",Auraiya,"1379545","740040","639505","391622","150","234222","1145323","269780","143971","125809","81093","24","42658","227122",1444126.000000000000000,1541438.000000000000000
"496","9",Uttar Pradesh,"167",Lalitpur,"1221592","641011","580581","240519","71610","175378","1046214","251507","132851","118656","50815","15243","30124","221383",1279238.000000000000000,1339171.000000000000000
"497","9",Uttar Pradesh,"169",Mahoba,"875958","466358","409600","220898","647","185381","690577","174186","92280","81906","46717","145","34971","139215",792491.000000000000000,995753.999999999883585
"498","9",Uttar Pradesh,"164",Kanpur Nagar,"4581268","2459806","2121462","816754","3753","3015645","1565623","739630","395398","344232","148763","702","445981","293649",5605794.000000000000000,5203658.000000000000000
"499","9",Uttar Pradesh,"183",Gonda,"3433919","1787146","1646773","531973","870","225029","3208890","736523","387748","348775","114417","177","41157","695366",3467742.000000000000000,3700389.000000000000000
"500","9",Uttar Pradesh,"176",Bara Banki,"3260699","1707073","1553626","864559","610","330803","2929896","664397","346650","317747","176609","130","62015","602382",2893183.000000000000000,3657424.000000000000000
"501","9",Uttar Pradesh,"174",Kaushambi,"1599596","838485","761111","555397","193","124456","1475140","351566","184092","167474","128432","52","25378","326188",1698942.000000000000000,1432718.000000000000000
"502","9",Uttar Pradesh,"194",Jaunpur,"4494204","2220465","2273739","990345","4736","346580","4147624","943775","488959","454816","218769","1012","65135","878640",4696472.000000000000000,5084428.000000000000000
"503","9",Uttar Pradesh,"191",Azamgarh,"4613913","2285004","2328909","1171378","9327","393401","4220512","984590","504701","479889","258942","1955","81531","903059",5249864.000000000000000,5417247.000000000000000
"504","9",Uttar Pradesh,"192",Mau,"2205968","1114709","1091259","474537","22915","499208","1706760","468956","241451","227505","101947","4973","106902","362054",1823235.999999999767169,2307167.000000000000000
"505","20",Jharkhand,"366",Gumla,"1025213","514390","510823","32459","706754","65081","960132","216792","109639","107153","6637","152866","13036","203756",902727.000000000000000,1127111.000000000000000
"506","20",Jharkhand,"359",Latehar,"726978","369666","357312","154910","331096","51858","675120","164125","83207","80918","36488","76930","9968","154157",850094.000000000116415,809537.999999999883585
"507","20",Jharkhand,"363",Jamtara,"791042","404830","386212","72885","240489","75746","715296","148652","76270","72382","14059","44392","12575","136077",1000013.000000000000000,1089755.000000000000000
"508","20",Jharkhand,"362",Dumka,"1321442","668514","652928","79614","571077","90178","1231264","246893","126469","120424","15575","104902","14881","232012",1302273.000000000000000,1453755.000000000000000
"509","29",Karnataka,"577",Mysore,"3001127","1511600","1489527","536643","334547","1245413","1755714","403312","205186","198126","76413","48822","161523","241789",3194244.000000000000000,3359051.000000000000000
"510","29",Karnataka,"578",Chamarajanagar,"1020791","512231","508560","259445","120219","174974","845817","133003","68162","64841","35037","16362","24083","108920",1004675.000000000000000,1028660.000000000000000
"511","29",Karnataka,"573",Mandya,"1805769","905085","900684","265294","22402","308362","1497407","232636","120721","111915","36152","3154","42194","190442",1802592.000000000000000,1846307.999999999767169
"512","29",Karnataka,"584",Ramanagara,"1082636","548008","534628","203819","22946","267759","814877","142205","73690","68515","28124","3640","40280","101925",1188974.000000000000000,1185655.000000000000000
"513","29",Karnataka,"572",Bangalore,"9621551","5022661","4598890","1198385","190239","8749944","871607","1154086","593677","560409","171240","24987","1043503","110583",10035238.000000000000000,10451373.000000000000000
"514","29",Karnataka,"583",Bangalore Rural,"990923","509172","481751","213700","52903","268744","722179","132743","68473","64270","31544","7561","37271","95472",1130843.000000000000000,1130052.000000000000000
"515","29",Karnataka,"582",Chikkaballapura,"1255104","636437","618667","312565","156487","281119","973985","183358","94473","88885","49795","23628","43549","139809",1210551.000000000000000,1299800.000000000000000
"516","29",Karnataka,"571",Tumkur,"2678980","1350594","1328386","506901","209559","599078","2079902","358485","186367","172118","73631","28590","83757","274728",2794147.000000000000000,2867175.000000000000000
"517","10",Bihar,"205",Sheohar,"656246","346673","309573","96655","318","28116","628130","143318","76218","67100","22029","72","6216","137102",812523.000000000000000,1045881.000000000000000
"518","29",Karnataka,"576",Kodagu,"554519","274608","279911","73584","58054","80988","473531","79274","40095","39179","11250","9662","11407","67867",588820.000000000000000,617360.000000000000000
"519","29",Karnataka,"575",Dakshina Kannada,"2089649","1034714","1054935","148178","82268","996086","1093563","269953","138467","131486","20304","10368","124952","145001",2126694.000000000000000,2362304.000000000000000
"520","29",Karnataka,"574",Hassan,"1776421","883667","892754","345031","32329","376763","1399658","230630","116971","113659","50942","4646","52764","177866",2002594.000000000000000,2036651.000000000000000
"521","29",Karnataka,"570",Chikmagalur,"1137961","566622","571339","253651","44970","239508","898453","153336","78197","75139","39135","7172","33840","119496",1235192.000000000000000,1257733.000000000000000
"522","29",Karnataka,"569",Udupi,"1177361","562131","615230","75429","52897","334061","843300","137171","69710","67461","9735","7099","37197","99974",1298815.000000000000000,1116532.000000000000000
"523","29",Karnataka,"567",Davanagere,"1945497","986400","959097","392595","233112","629010","1316487","281457","144420","137037","62584","35146","92303","189154",2125007.000000000000000,2123554.000000000000000
"524","29",Karnataka,"566",Chitradurga,"1659456","840843","818613","389117","302554","329533","1329923","238108","122571","115537","61874","46327","48578","189530",1434417.000000000000000,1745192.000000000000000
"525","29",Karnataka,"565",Bellary,"2452595","1236954","1215641","517409","451406","920239","1532356","401998","205452","196546","94729","80988","141386","260612",2797730.000000000000000,2556924.000000000000000
"526","29",Karnataka,"560",Koppal,"1389920","699926","689994","258608","164271","233704","1156216","243095","124552","118543","50133","31119","38401","204694",1319990.000000000000000,1491080.000000000000000
"527","29",Karnataka,"564",Haveri,"1597668","819128","778540","219976","141380","355501","1242167","241663","123879","117784","36967","21261","56811","184852",1465321.000000000000000,1680650.000000000000000
"528","29",Karnataka,"561",Gadag,"1064570","537147","527423","174196","61654","379309","685261","159639","81672","77967","30865","9371","56736","102903",1272104.000000000000000,1148293.000000000000000
"529","29",Karnataka,"562",Dharwad,"1847023","937206","909817","177855","87548","1049539","797484","268685","138036","130649","28429","13622","150939","117746",1775475.999999999767169,1991518.000000000000000
"530","29",Karnataka,"563",Uttara Kannada,"1437169","726256","710913","116431","34239","418981","1018188","197095","102036","95059","17568","5450","56919","140176",1539244.000000000232831,1614693.000000000000000
"531","29",Karnataka,"556",Bagalkot,"1889752","950111","939641","319149","97203","597846","1291906","315680","162132","153548","60183","16958","94706","220974",2428265.000000000000000,2106003.000000000000000
"532","29",Karnataka,"559",Raichur,"1928812","964511","964301","400933","367071","490348","1438464","340161","174154","166007","76351","69823","82067","258094",2074332.000000000232831,2122311.000000000000000
"533","29",Karnataka,"580",Yadgir,"1174271","590329","583942","273315","146849","220677","953594","222825","114746","108079","55807","28969","40042","182783",1070624.000000000000000,1286478.000000000000000
"534","29",Karnataka,"557",Bijapur,"2177331","1111022","1066309","442773","39314","501978","1675353","373387","193861","179526","84249","7031","83499","289888",1798782.000000000000000,2297148.000000000000000
"535","29",Karnataka,"558",Bidar,"1703300","870665","832635","399785","235822","425952","1277348","299568","153372","146196","74617","43353","77267","222301",1770670.000000000000000,1818434.000000000000000
"536","32",Kerala,"601",Thiruvananthapuram,"3301427","1581678","1719749","372977","26759","1771596","1529831","400219","203403","196816","45537","3635","206961","193258",3421957.000000000000000,3290382.000000000000000
"537","32",Kerala,"600",Kollam,"2635375","1246968","1388407","328263","10761","1187158","1448217","328763","167596","161167","40709","1557","149682","179081",2498618.000000000000000,2587625.000000000000000
"538","32",Kerala,"597",Kottayam,"1974551","968289","1006262","153909","21972","565393","1409158","239363","121662","117701","19270","2717","69361","170002",1934922.000000000000000,1902497.000000000000000
"539","32",Kerala,"596",Idukki,"1108974","552808","556166","145486","55815","52045","1056929","141697","72161","69536","19067","7363","6761","134936",1028809.999999999883585,978581.000000000000000
"540","32",Kerala,"594",Thrissur,"3121200","1480763","1640437","324350","9430","2096406","1024794","384642","196183","188459","38140","1640","258065","126577",3176697.000000000000000,3081503.000000000000000
"541","32",Kerala,"593",Palakkad,"2809934","1359478","1450456","403833","48972","676810","2133124","375895","191071","184824","55126","7997","87897","287998",3005019.000000000000000,2827713.000000000000000
"542","32",Kerala,"588",Kasaragod,"1307375","628613","678762","53283","48857","509047","798328","186889","95606","91283","7335","7143","73296","113593",1401196.000000000232831,1369753.000000000000000
"543","32",Kerala,"591",Kozhikode,"3086293","1470942","1615351","199191","15228","2072572","1013721","414047","211612","202435","24584","2128","274680","139367",3223431.000000000000000,3070416.000000000000000
"544","32",Kerala,"589",Kannur,"2523003","1181446","1341557","83350","41371","1640986","882017","320093","163105","156988","9388","5818","206285","113808",2653248.000000000000000,2557430.000000000000000
"545","12",Arunachal Pradesh,"259",Lohit,"145726","76221","69505","0","47410","32430","113296","29029","14833","14196","0","10009","5951","23078",166194.000000000000000,164417.000000000000000
"546","10",Bihar,"206",Sitamarhi,"3423574","1803252","1620322","405714","2989","190498","3233076","751238","399013","352225","92086","689","37837","713401",4142525.000000000000000,3670917.000000000000000
"547","2",Himachal Pradesh,"27",Mandi,"999777","498065","501712","293739","12787","62637","937140","146279","76192","70087","46526","2038","7619","138660",1071814.000000000000000,1041784.000000000000000
"548","27",Maharashtra,"529",Sindhudurg,"849651","417332","432319","55586","6976","107006","742645","110942","57138","53804","7477","1050","13439","97503",875788.000000000000000,924670.000000000116415
"549","27",Maharashtra,"527",Satara,"3003741","1510842","1492899","323236","29635","570378","2433363","413701","220320","193381","46856","5049","81394","332307",2955661.000000000000000,3193345.000000000000000
"550","27",Maharashtra,"518",Mumbai Suburban,"9356962","5031323","4325639","583302","104560","9356962","0","1186048","627096","558952","80802","14475","1186048","0",9274263.000000000000000,10548098.000000000000000
"551","27",Maharashtra,"523",Bid,"2585049","1349106","1235943","351254","32722","514298","2070751","417793","224129","193664","60336","6213","84319","333474",2504992.000000000000000,2544062.000000000000000
"552","27",Maharashtra,"514",Jalna,"1959046","1011473","947573","272266","42263","377429","1581617","326263","171836","154427","48379","7906","62252","264011",1984193.000000000000000,2059987.999999999767169
"553","2",Himachal Pradesh,"32",Sirmaur,"529855","276289","253566","160745","11262","57165","472690","86841","45347","41494","29022","2067","7879","78962",546006.000000000000000,567148.000000000000000
"554","2",Himachal Pradesh,"31",Solan,"580320","308754","271566","164536","25645","102147","478173","83589","44436","39153","25287","3971","13068","70521",612767.000000000000000,607280.000000000000000
"555","27",Maharashtra,"507",Gondiya,"1322507","661554","660953","175961","214253","225930","1096577","198755","101328","97427","25050","38347","31677","167078",1133611.000000000000000,1240639.000000000000000
"556","27",Maharashtra,"515",Aurangabad,"3701282","1924469","1776813","539368","143366","1620170","2081112","608647","324070","284577","90904","28600","257283","351364",4089889.000000000000000,4213048.000000000000000
"557","27",Maharashtra,"510",Yavatmal,"2772348","1419965","1352383","328518","514057","598153","2174195","436289","227255","209034","50598","90110","87998","348291",2917825.000000000000000,3020537.000000000000000
"558","27",Maharashtra,"501",Akola,"1813906","932334","881572","364059","100280","719741","1094165","275919","142846","133073","57563","17541","106840","169079",1985398.000000000000000,2030176.000000000000000
"559","10",Bihar,"227",Lakhisarai,"1000912","526345","474567","153209","8333","143011","857901","218377","114896","103481","34486","1866","28947","189430",1051246.000000000000000,1163640.000000000000000
"560","27",Maharashtra,"498",Dhule,"2050862","1054031","996831","127571","647315","571036","1479826","344895","183657","161238","21367","132094","88561","256334",2258494.000000000000000,2238535.000000000000000
"561","27",Maharashtra,"497",Nandurbar,"1648295","833170","815125","47985","1141933","275474","1372821","318284","166160","152124","8022","238363","48674","269610",1703603.999999999767169,1883507.999999999767169
"562","2",Himachal Pradesh,"28",Hamirpur,"454768","217070","237698","109256","3044","31430","423338","62825","34137","28688","15682","476","4299","58526",480832.999999999941792,472883.000000000058208
"563","14",Manipur,"273",Tamenglong,"140651","72371","68280","22","134626","19363","121288","25714","13235","12479","6","24996","3955","21759",136342.000000000000000,142237.000000000000000
"564","2",Himachal Pradesh,"34",Kinnaur,"84121","46249","37872","14750","48746","0","84121","10522","5224","5298","2394","6152","0","10522",89245.000000000000000,88318.000000000000000
"565","14",Manipur,"280",Chandel,"144182","74579","69603","540","128280","16847","127335","23287","11893","11394","81","21370","3251","20036",107374.000000000000000,166471.000000000000000
"566","14",Manipur,"275",Bishnupur,"237399","118782","118617","22113","3287","87505","149894","39567","20240","19327","3478","508","14092","25475",238464.000000000000000,261142.000000000000000
"567","15",Mizoram,"288",Saiha,"56574","28594","27980","83","54642","25110","31464","10733","5438","5295","8","10517","4601","6132",58622.000000000000000,47485.000000000000000
"568","2",Himachal Pradesh,"30",Bilaspur,"381956","192764","189192","98989","10693","25129","356827","51822","27564","24258","13827","1521","3506","48316",388619.000000000058208,409504.999999999941792
"569","15",Mizoram,"287",Lawngtlai,"117894","60599","57295","146","112354","20830","97064","23415","12219","11196","19","22644","3585","19830",114716.000000000000000,141415.000000000000000
"570","15",Mizoram,"285",Serchhip,"64937","32851","32086","32","62889","32019","32918","11172","5548","5624","7","10966","5375","5797",56774.000000000000000,81952.000000000000000
"571","15",Mizoram,"283",Aizawl,"400309","199270","201039","627","373542","314754","85555","60262","30326","29936","79","57060","45853","14409",427048.000000000000000,431684.000000000000000
"572","15",Mizoram,"281",Mamit,"86364","44828","41536","51","82080","14899","71465","15839","8269","7570","5","15174","2489","13350",90895.000000000000000,96218.000000000000000
"573","10",Bihar,"220",Vaishali,"3495021","1844535","1650486","738031","2274","233079","3261942","721644","379723","341921","160676","458","45589","676055",3019863.000000000000000,3995278.000000000000000
"574","6",Haryana,"69",Panchkula,"561293","299679","261614","101830","0","313230","248063","83092","45645","37447","17906","0","43507","39585",584180.000000000000000,639920.000000000000000
"575","6",Haryana,"70",Ambala,"1128350","598703","529647","296246","0","500774","627576","157125","88717","68408","47259","0","64879","92246",1402063.000000000000000,1249170.000000000000000
"576","6",Haryana,"71",Yamuna-Nagar,"1214205","646718","567487","306743","0","472829","741376","184828","102733","82095","50843","0","66796","118032",1094206.000000000000000,1296824.000000000000000
"577","6",Haryana,"72",Kurukshetra,"964655","510976","453679","215128","0","279225","685430","143201","81151","62050","36263","0","38185","105016",1056498.000000000000000,1131860.000000000000000
"578","6",Haryana,"77",Jind,"1334152","713006","621146","282351","0","305583","1028569","221142","121104","100038","53591","0","47734","173408",1245139.999999999767169,1496912.000000000000000
"579","6",Haryana,"73",Kaithal,"1074304","571003","503301","247513","0","236011","838293","171968","95319","76649","44614","0","35940","136028",1165436.000000000000000,1178956.000000000000000
"580","6",Haryana,"75",Panipat,"1205437","646857","558580","206213","0","555085","650352","204711","113103","91608","37994","0","91137","113574",1031993.999999999883585,1406711.000000000000000
"581","6",Haryana,"76",Sonipat,"1450001","781299","668702","269935","0","453364","996637","232773","130028","102745","47958","0","69476","163297",1471335.000000000000000,1577580.000000000232831
"582","6",Haryana,"81",Bhiwani,"1634445","866672","767773","341162","0","321322","1313123","269617","147026","122591","62081","0","50025","219592",1712528.000000000000000,1809723.000000000000000
"583","17",Meghalaya,"299",Jaintia Hills,"395124","196285","198839","1317","376099","28430","366694","87948","43824","44124","233","84398","5416","82532",412556.000000000000000,464420.999999999941792
"584","6",Haryana,"82",Rohtak,"1061204","568479","492725","216889","0","446164","615040","163458","90661","72797","38602","0","64664","98794",1057941.000000000000000,1167970.000000000000000
"585","6",Haryana,"83",Jhajjar,"958405","514667","443738","170448","0","243339","715066","147136","82811","64325","28999","0","37136","110000",938404.000000000000000,1018064.000000000000000
"586","6",Haryana,"84",Mahendragarh,"922088","486665","435423","156314","0","132855","789233","149322","82682","66640","27872","0","20796","128526",1157815.000000000000000,1038489.999999999883585
"587","6",Haryana,"87",Mewat,"1089263","571162","518101","75251","0","124106","965157","261096","139538","121558","16366","0","26281","234815",985067.000000000000000,1261927.000000000000000
"588","6",Haryana,"88",Faridabad,"1809733","966110","843623","223799","0","1438855","370878","304633","166484","138149","42762","0","234304","70329",1985392.000000000000000,1994035.999999999767169
"589","6",Haryana,"89",Palwal,"1042708","554497","488211","203123","0","236544","806164","208901","113208","95693","42330","0","42680","166221",1008694.000000000116415,1136199.000000000000000
"590","17",Meghalaya,"295",South Garo Hills,"142334","73170","69164","319","134237","13131","129203","29213","14922","14291","51","28007","2714","26499",169871.000000000000000,162527.000000000000000
"591","17",Meghalaya,"297",Ribhoi,"258840","132531","126309","590","230081","25253","233587","56583","28905","27678","93","51912","4742","51841",167848.000000000000000,228470.000000000000000
"593","16",Tripura,"290",South Tripura,"876001","447544","428457","140168","344835","123031","752970","139624","71450","68174","20025","67736","14925","124699",936262.000000000116415,889531.000000000000000
"594","16",Tripura,"291",Dhalai,"378230","194544","183686","61688","210608","40499","337731","65844","33826","32018","9517","42252","5491","60353",309475.000000000058208,405724.000000000000000
"595","10",Bihar,"212",Katihar,"3071029","1600430","1470599","263100","179971","273822","2797207","687870","355236","332634","59444","39158","51310","636560",3043916.000000000000000,3518229.000000000000000
"596","18",Assam,"321",Kamrup,"1517542","778461","739081","107827","182038","142394","1375148","259349","132679","126670","18179","30270","19692","239657",1406031.000000000000000,1925638.000000000000000
"597","10",Bihar,"213",Madhepura,"2001762","1047559","954203","346275","12532","88461","1913301","448913","236296","212617","81993","2895","17746","431167",1988368.000000000000000,2387546.000000000000000
"598","12",Arunachal Pradesh,"256",Kurung Kumey,"92076","45318","46758","0","90764","2345","89731","22450","11386","11064","0","22273","514","21936",85226.000000000000000,100190.000000000000000
"599","12",Arunachal Pradesh,"247",East Kameng,"78690","38775","39915","0","72400","18350","60340","18925","9351","9574","0","17715","4442","14483",100143.000000000000000,93745.000000000000000
"600","12",Arunachal Pradesh,"245",Tawang,"49977","29151","20826","0","34811","11202","38775","7889","3798","4091","0","6842","937","6952",52089.000000000000000,57423.000000000000000
"601","10",Bihar,"210",Kishanganj,"1690400","866970","823430","113118","64224","161123","1529277","384594","195535","189059","24879","13409","32434","352160",1897025.000000000000000,1955650.000000000000000
"602","12",Arunachal Pradesh,"252",Upper Siang,"35320","18699","16621","0","28468","6540","28780","6883","3481","3402","0","5725","1406","5477",34292.000000000000000,41657.000000000000000
"603","12",Arunachal Pradesh,"257",Dibang Valley,"8004","4414","3590","0","5701","2384","5620","1468","744","724","0","1173","418","1050",21339.000000000000000,13665.000000000000000
"604","18",Assam,"304",Morigaon,"957423","486651","470772","117841","136777","73298","884125","188540","95988","92552","21671","25087","11206","177334",1071355.000000000000000,1026168.000000000000000
"605","18",Assam,"308",Dhemaji,"686133","351249","334884","44225","325560","48285","637848","130732","66913","63819","9324","63644","7977","122755",832308.000000000000000,640949.000000000000000
"606","12",Arunachal Pradesh,"260",Anjaw,"21167","11507","9660","0","16451","982","20185","4315","2299","2016","0","3807","223","4092",56346.000000000000000,23918.000000000000000
"607","18",Assam,"307",Lakhimpur,"1042137","529674","512463","81840","249426","91333","950804","190334","97208","93126","15077","48577","13798","176536",999614.000000000116415,1278691.000000000000000
"608","18",Assam,"316",Cachar,"1736617","886284","850333","264897","17569","315464","1421153","301597","153867","147730","47252","2751","44045","257552",1866822.000000000000000,1759926.000000000000000
"609","18",Assam,"315",Dimahasao,"214102","110802","103300","4337","151843","62489","151613","39303","20112","19191","717","29306","10005","29298",231744.000000000000000,250129.000000000000000
"610","18",Assam,"314",Karbi Anglong,"956313","490167","466146","44961","538738","112966","843347","184209","94011","90198","8707","107592","18502","165707",987021.000000000000000,1268279.000000000000000
"611","18",Assam,"309",Tinsukia,"1327929","680231","647698","37688","82066","264743","1063186","230295","118113","112182","6166","14503","36166","194129",1526075.000000000000000,1330923.000000000000000
"612","18",Assam,"310",Dibrugarh,"1326335","676434","649901","58876","102871","243730","1082605","214268","110109","104159","9634","14658","30823","183445",1288641.000000000000000,1577340.000000000232831
"613","18",Assam,"311",Sivasagar,"1151050","589216","561834","42347","49039","110096","1040954","183410","93926","89484","6826","8598","14717","168693",1211269.000000000000000,1281052.000000000232831
"614","18",Assam,"312",Jorhat,"1092256","556805","535451","88665","139971","220534","871722","168356","86386","81970","15118","25016","28867","139489",1128047.000000000000000,1160206.000000000000000
"615","18",Assam,"302",Goalpara,"1008183","513292","494891","45094","231570","138062","870121","192415","98695","93720","7691","39417","23237","169178",806545.000000000000000,1278536.000000000000000
"616","18",Assam,"319",Bongaigaon,"738804","375818","362986","82784","18835","109810","628994","136855","70138","66717","14525","3223","14853","122002",628064.000000000000000,902041.999999999883585
"617","18",Assam,"303",Barpeta,"1693622","867004","826618","95320","27344","147353","1546269","329036","169054","159982","16221","4558","20385","308651",1471596.000000000232831,1706809.000000000000000
"618","18",Assam,"300",Kokrajhar,"887142","452905","434237","29570","278665","54941","832201","163913","83927","79986","4975","48039","7327","156586",1220652.000000000232831,1006056.000000000000000
"619","10",Bihar,"217",Gopalganj,"2562012","1267666","1294346","320064","60807","162805","2399207","575404","293616","281788","74675","14322","34678","540726",2831777.000000000000000,2907328.000000000000000
"620","10",Bihar,"223",Khagaria,"1666886","883786","783100","247161","675","87159","1579727","377087","200120","176967","58483","157","17677","359410",1684305.000000000000000,1896546.000000000000000
"621","10",Bihar,"225",Banka,"2034763","1067140","967623","247858","90432","71313","1963450","428090","224500","203590","54473","19092","13838","414252",2530071.000000000000000,2279820.000000000000000
"622","10",Bihar,"235",Aurangabad,"2540073","1318684","1221389","612064","1033","236854","2303219","549233","283886","265347","138960","234","48806","500427",2466035.000000000000000,2853689.000000000000000
"623","4",Chandigarh,"55",Chandigarh,"1055450","580663","474787","199086","0","1026459","28991","147078","81206","65872","33133","0","142869","4209",1351347.000000000000000,1159916.000000000000000
"624","7",NCT of Delhi,"91",North,"887978","475002","412976","165663","0","870232","17746","133145","71772","61373","25745","0","129891","3254",1080977.000000000000000,980726.000000000116415
"625","7",NCT of Delhi,"92",North East,"2241624","1188425","1053199","373758","0","2220097","21527","381984","204827","177157","62415","0","377939","4045",1505548.000000000232831,2027527.000000000000000
"626","7",NCT of Delhi,"95",Central,"582320","307821","274499","143178","0","582320","0","78333","41358","36975","19814","0","78333","0",647063.000000000000000,672783.000000000000000
"627","7",NCT of Delhi,"94",New Delhi,"142004","77942","64062","33245","0","142004","0","18487","9838","8649","4923","0","18487","0",1056920.000000000000000,141004.000000000000000
"628","7",NCT of Delhi,"93",East,"1709346","907500","801846","281422","0","1705816","3530","244057","132430","111627","45815","0","243674","383",1862963.000000000000000,1772570.000000000000000
"629","7",NCT of Delhi,"97",South West,"2292958","1246046","1046912","318408","0","2149282","143676","329998","181661","148337","51383","0","307432","22566",2521630.000000000000000,2330729.000000000000000
"630","7",NCT of Delhi,"96",West,"2543243","1356240","1187003","376472","0","2536823","6420","364635","198566","166069","61573","0","363637","998",2326114.000000000000000,2832130.000000000000000
"631","24",Gujarat,"482",Anand,"2092745","1087224","1005521","104465","24824","634987","1457758","317218","172016","145202","14717","4420","89061","228157",2319876.000000000000000,2308871.000000000000000
"632","24",Gujarat,"478",Porbandar,"585449","300209","285240","51830","13039","285674","299775","92712","48536","44176","9054","2571","43003","49709",686483.000000000000000,656862.000000000116415
"633","24",Gujarat,"477",Jamnagar,"2160119","1114192","1045927","173895","24187","971065","1189054","347352","183581","163771","29857","4673","147836","199516",2244195.000000000000000,2327944.000000000000000
"634","29",Karnataka,"579",Gulbarga,"2566326","1301755","1264571","648782","65259","835551","1730775","454565","235003","219562","122216","12308","141321","313244",2885381.000000000000000,2778391.000000000000000
"635","25",Daman & Diu,"495",Daman,"191173","124659","66514","4262","15240","158860","32313","18986","10339","8647","600","2339","14795","4191",231021.000000000000000,150816.000000000000000
"636","25",Daman & Diu,"494",Diu,"52074","25642","26432","1862","123","23991","28083","9065","4665","4400","268","11","3418","5647",9038.000000000000000,57689.000000000000000
"637","34",Puducherry,"635",Puducherry,"950289","468258","482031","152406","0","657209","293080","123915","63468","60447","23061","0","82737","41178",1145415.000000000000000,1134359.000000000000000
"638","34",Puducherry,"634",Yanam,"55626","27301","28325","8427","0","55626","0","8869","4458","4411","1302","0","8869","0",16123.000000000000000,15662.000000000000000
"641","35",Andaman and Nicobar Islands,"640",South Andaman,"238142","127283","110859","0","4091","140747","97395","31623","16218","15405","0","584","18737","12886",234336.000000000000000,227986.000000000000000
"642","36",Telangana,"536",Hyderabad,"3943323","2018575","1924748","35357","48937","3943323","0","588600","304665","283935","35357","8488","588600","0",5749507.000000000000000,5537776.000000000931323
"643","27",Maharashtra,"522",Ahmadnagar,"4543159","2342825","2200334","573698","378230","912617","3630542","686511","367700","318811","93234","71957","132372","554139",4733814.000000000000000,4846804.000000000000000
"640","35",Andaman and Nicobar Islands,"639",North and Middle Andaman,"105597","54861","50736","0","758","2741","102856","16074","8182","7892","0","115","309","15765",110257.000000000000000,104439.000000000000000
,"35",Andaman and Nicobar Islands,"638",Nicobars,"36842","20727","16115","0","23681","0","36842","4100","2101","1999","0","2799","0","4100",29253.000000000000000,26574.000000000000000
